آا	aa
آبادي	abadie
آبي	abe
آبيلارد	abelard
آتوود	atwood
آدان	adan
آدر	ader
آدكنز	adkins
آدم	adam
آدمسون	adamson
آذري	azari
آراد	arad
آرام	aram
آراو	arrau
آرتس	aarts
آرتشيبنكو	archipenko
آرتيرتون	arterton
آرثرز	arthurs
آردن	ardenne
آرسي	arce
آرغريتش	argerich
آرغوف	argov
آركرايت	arkwright
آركين	arkin
آرلانديز	d'arlandes
آرميسين	armisen
آرنت	arnett
آرون	aaron
آرونسون	aaronsohn
آرياس	arias
آريس	aires
آزاريا	azaria
آس	aas
آسك	aske
آش	esch
آشر	asher
آشكراوفت	ashcroft
آشور	ashur
آصف	asif
آغازاده	aghazadeh
آغر	agger
آغوريغاري	aguirregaray
آغوس	agus
آفا	ava
آفاتسمارك	aavatsmark
آقجورا	akcura
آكاييف	akayev
آكلز	ackles
آلان	alan
آلتونن	aaltonen
آلدورث	aldworth
آلمارك	ahlmark
آلي	ally
آلياس	allais
آم	amm
آمون	meritamun
آمينابار	amenabar
آن	anne
آنج	ange
آنجرير	angerer
آنغر	ingres
آني	annie
آهي	ahhe
آو	ao
آوغنتالر	augenthaler
آوغو	aogo
آويني	avini
آيات	ayat
آيبا	aiba
آيت	ait
آيتوج	aytug
آيخمان	eichmann
آير	ayer
آيرا	ira
آيرتون	ayrton
آيري	airi
آيزارد	izzard
آيزنشتاين	eisenstein
آيزنك	eysenck
آيزينبيرغ	eisenberg
آيكارت	aicart
آيكن	aiken
آيلزاري	elizari
آيمي	aimee
آين	ayn
أ.	a.
أبا	abba
أباتشا	abacha
أبادو	abbado
أباردونادو	abardonado
أباريسيدو	aparecido
أباشيلي	abasheli
أباظة	abaza
أباقا	abaqa
أبان	aban
أبانياله	abbagnale
أبتون	upton
أبتيد	apted
أبثورب	apthorp
أبجر	abgar
أبدرهالين	abderhalden
أبرازفسكي	abraszewski
أبراشكين	abrashkin
أبرامز	abrams
أبراموف	abramov
أبراهام	abraham
أبراهامز	abrahams
أبركرمبي	abercromby
أبرهون	aberhoun
أبرو	ebru
أبروتشاتو	abbruscato
أبريل	april
أبريو	abreu
أبرييل	abriel
أبغار	apgar
أبلاي	aballay
أبلتون	appleton
أبلغيت	applegate
أبليازوف	ablyazov
أبن	abene
أبهوف	uphoff
أبو	abu
أبوالخير	abulkhair
أبوبكر	aboubakar
أبوت	abbott
أبوستول	apostol
أبولينير	apollinaire
أبوندازيري	abbondanzieri
أبي	abi
أبياتي	abbiati
أبياه	appiah
أبيتي	abetti
أبيجيل	abigail
أبيدال	abidal
أبيرت	abert
أبيس	abbis
أبيغا	abega
أبيغلين	abegglen
أبيكيلا	apicella
أبيلار	abelard
أبيلز	abels
أبيليانيدا	avellaneda
أبيي	abbey
أبييف	abiyev
أتا	atta
أتالوس	attalus
أتبرور	atabrour
أترام	attram
أتزوري	atzori
أتسكو	atsuko
أتسمي	utsumi
أتسو	atsu
أتشوكارو	achucarro
أتشياما	uchiyama
أتشيمبونغ	acheampong
أتكينس	atkins
أتكينسون	atkinson
أتلي	attlee
أتوري	autuori
أتوود	attwood
أتويل	atwell
أتينبارا	attenborough
أتينولف	atenulf
أثال	uthal
أثانيا	azana
أثنار	aznar
أثويلا	azuela
أجاثا	agatha
أجدو‎	ajeddou
أجريبا	agrippa
أجستوس	adjutus
أجيس	agis
أحدي	ahadi
أحلام	ahlam
أحمد	ahmed
أحمدوف	ahmedow
أحمدي	ahmadi
أخارد	achard
أختر	akhtar
أخماتوفا	akhmatova
أخيم	achim
أداتشي	adachi
أدالبيرت	adalbert
أداما	adama
أداماري	adamari
أدامز	adams
أداموف	adamov
أداميتش	adamich
أدانسون	adanson
أدجاني	adjani
أدجي	adjei
أدريانو	adriano
أدسيت	adsit
أدفوكات	advocaat
أدلاند	aadland
أدلر	adler
أدلستين	adelstein
أدلكيس	adelchis
أدهم	adham
أدولف	adolf
أدونياس	adonias
أديبايور	adebayor
أدير	ader
أديركا	aderca
أديس	ades
أديكو	adiko
أديل	adele
أديلسون	adelson
أدينسيل	addinsell
أدينون	adenon
أديوار	adıvar
أديياه	adiyiah
أدیب	adibzadeh
أرابال	arrabal
أرادوري	aradori
أراغو	arago
أراغون	aragon
أراغونيسيس	aragoneses
أرافينا	aravena
أرانا	arana
أرانز	arranz
أرانزابال	aranzabal
أرانزوبيا	aranzubia
أرانغو	arango
أراني	arany
أراوجو	araujo
أراي	arai
أرباز	arbaaz
أربت	arbet
أربوثنوت	arbuthnot
أربيلوا	arbeloa
أرت	art
أرتشونديا	archundia
أرتو	arto
أرتور	artur
أرتورو	arturo
أرتي	artie
أرتيتا	arteta
أرتيغاس	artigas
أرتين	artin
أرتيوموف	artemov
أرجان	arjan
أرجون	arjun
أرخيداموس	archidamus
أرخيلاوس	archelaus
أردا	arda
أردان	erdan
أردشير	ardashir
أردن	arden
أردوغان	erdogan
أرديزوغلو	ardizoglou
أرديليس	ardiles
أرزواغا	arzuaga
أرزومانيان	arzumanyan
أرسا	arca
أرستبوس	aristippus
أرسطو	aristotle
أرسلان	arslan
أرسينوي	arsinoe
أرشيبالد	archibald
أرضاشيس	artaxias
أرغايوس	argaeus
أرغنزينو	argenziano
أرغوتي	argote
أرغيزي	arghezi
أرغيل	argyll
أرغيو	arguello
أرفي	arvi
أرفيد	arvid
أرفيسون	arveson
أركاديو	arcadio
أركانجيلي	arcangeli
أركون	arkoun
أركيت	arquette
أرلوندو	arnoldo
أرليس	arliss
أرماس	armas
أرماند	armand
أرماندو	armando
أرماني	armani
أرمسترونغ	armstrong
أرملة	armalet
أرمومن	armoumen
أرميت	armet
أرميص	ermes
أرمين	armin
أرمينتيروس	armenteros
أرمينيا	armenia
أرناؤوط	arnaout
أرنالدو	arnaldo
أرنبيورن	arnbjørn
أرنتز	arntz
أرنزيدير	arnezeder
أرنو	arnaud
أرنوت	arnott
أرنوفسكي	aronofsky
أرنولد	arnold
أرنولين	arnolin
أرني	arne
أرنيم	arnim
أرو	arrow
أروتينيان	arutyunian
أرورا	arora
أروسيفا	aroseva
أرون	aron
أرونا	arouna
أرونداتي	arundhati
أرونسون	aronson
أرونيكا	aronica
أرياتي	ariatti
أريان	aryan
أريبرت	aripert
أريتينو	aretino
أريثا	aretha
أريجبابو	arigbabu
أريزا	ariza
أريس	ayres
أريساوا	arisawa
أريستيد	aristide
أريغوني	arrigoni
أريكو	arico
أريكيس	arechis
أريل	aerle
أريلانو	arellano
أرينا	arena
أريوستو	ariosto
أريولا	arreola
أرييس	aries
أزاريان	azaryan
أزارينكا	azarenka
أزبيليكويتا	azpilicueta
أزعور	azour
أزمون	azmoun
أزنافور	aznavour
أزواغ	azaouagh
أزوفرا	azofra
أزولاي	azoulay
أزيليا	azealia
أسادوريان	assadourian
أساشوريو	asashoryu
أسافا	asafa
أسالي	assale
أسامة	osama
أسامواه	asamoah
أسامي	asami
أستريد	astrid
أستودييو	astudillo
أستور	astor
أستورياس	asturias
أستون	aston
أستينغو	astengo
أسد	asad
أسكيفولد	askevold
أسلم	aslam
أسماء	asma
أسمر	asmar
أسيريا	assyria
أسيل	aseel
أسيمواسا	assemoassa
أسينخو	asenjo
أسيير	asier
أش	ashe
أشام	ascham
أشبرغ	aschberg
أشبوت	asboth
أشبي	ashbee
أشتون	ashton
أشدون	ashdown
أشرسن	ascherson
أشرف	ashraf
أشفق	ashfaq
أشكنازي	ashkenazy
أشكول	eshkol
أشلي	ashley
أشلين	ashlynn
أشمور	ashmore
أشنهوغ	aschehoug
أشوف	aschoff
أشوورث	ashworth
أشيدا	ashida
أصفري	asfari
أصلان	aslan
أصيل	asil
أعتابو	aatabou
أعثم	a'tham
أعشى	a'sha
أعظم	azam
أغاسيز	agassiz
أغاهووا	aghahowa
أغاوا	agawa
أغبونلاهور	agbonlahor
أغري	agre
أغريكولا	agricola
أغستا	agusta
أغسطس	augustus
أغنيتا	agneta
أغنيس	agnes
أغوت	agut
أغوستين	agustin
أغوستينو	agostino
أغوم	agum
أغويرو	aguero
أغيري	aguirre
أغيلار	aguilar
أغيليرا	aguilera
أغينالدو	aguinaldo
أفار	avar
أفالوس	d'avalos
أفاناسيف	afanasyev
أفراميسكو	avramescu
أفروخ	avrukh
أفريبو	øvrebø
أفنيري	avnery
أفوجادرو	avogadro
أفول	afful
أفونسو	afonso
أفونين	afonin
أفيسون	iveson
أفيغدور	avigdor
أفيليس	aviles
أفيناريوس	avenarius
أفيهو	avihu
أقصبي	akesbi
أقينجي	akıncı
أكاتسوكا	akatsuka
أكاردي	accardi
أكافيا	akavia
أكام	accam
أكاي	akai
أكايا	akkaya
أكبان	akabane
أكبر	akbar
أكتريان	acterian
أكدال	agdal
أكرلوف	akerlof
أكرم	akram
أكرمان	ackermann
أكروبولس	acropolis
أكرور	akrour
أكرون	akroun
أكسل	axel
أكسيلسون	axelsson
أكمان	akman
أكمل	akmal
أكنو	akeno
أكوافريسكا	acquafresca
أكوستا	acosta
أكونور	akonnor
أكوير	accoyer
أكي	aki
أكيبا	akiba
أكيتا	akita
أكيساكا	akesaka
أكيموتو	akimoto
أكين	akin
أكينفيف	akinfeev
أكينو	aquino
أكينوري	akinori
أكيهيرو	akihiro
أكيو	akio
أكيول	akyol
ألابا	alaba
ألاباو	alabau
ألاركون	alarcon
ألاريك	alaric
ألازراكوي	alazraqui
ألاس	alas
ألاستير	alastair
ألاسكي	alaskey
ألاغيا	alagia
ألاغيتش	alagich
ألاكينا	alakina
ألامو	alamo
ألبا	alba
ألباك	allback
ألباكار	albacar
ألبان	alban
ألبانس	albans
ألباني	albany
ألبرتسون	albertson
ألبرتو	alberto
ألبرتيني	albertini
ألبريتون	albrighton
ألبريشت	albrecht
ألبو	albu
ألبورتا	alborta
ألبوركويركي	alburquerque
ألبوريتو	alboreto
ألبوليسكو	albulescu
ألبويو	alboiu
ألبيرتوس	albertus
ألبيروني	alberoni
ألبيزار	alpizar
ألبيلدا	albelda
ألبين	albin
ألبينيز	albeniz
ألبيول	albiol
ألتاميرانو	altamirano
ألتان	altan
ألتمان	altman
ألتوبيلي	altobelli
ألتوسير	althusser
ألثيا	althea
ألجرنون	algernon
ألخازيشفيلي	alkhazishvili
ألدا	alda
ألدانا	aldana
ألداي	alday
ألدر	alder
ألدرفايريلد	alderweireld
ألدروفاندي	aldrovandi
ألدريتش	aldrich
ألدريج	aldridge
ألدو	aldo
ألديس	aldiss
ألزهايمر	alzheimer
ألسيني	alseny
ألف	alf
ألفا	alva
ألفارادو	alvarado
ألفارو	alvaro
ألفاريلوس	alvarellos
ألفة	olfa
ألفتريادس	elefteriades
ألفريد	alfred
ألفريدو	alfredo
ألفونس	alphonse
ألفي	alfie
ألفيتيز	alvites
ألفيلن	alflen
ألفين	alvin
ألكازار	alcazar
ألكاسير	alcacer
ألكان	elkann
ألكانتارا	alcantara
ألكس	alex
ألكسندرا	alexandra
ألكسندروف	alexandrov
ألكسيوس	alexios
ألكسييف	alekseyev
ألكوت	alcott
ألكورن	alcorn
ألكوك	alcock
ألكيتاس	alcetas
ألماغرو	almagro
ألمان	allman
ألماند	allmand
ألمانيا	germany
ألمودينا	almudena
ألموغ	almog
ألموند	almond
ألميدا	almeida
ألميرو	almiro
ألمين	almen
ألوفس	allofs
ألوميا	alomia
ألون	alon
ألونسو	alonso
ألويس	alois
ألوين	allwine
أليخاندرو	alejandro
أليخين	alekhine
أليدا	aleida
أليرتس	allaerts
أليز	alize
أليس	alice
أليسا	alyssa
أليساندرا	alessandra
أليساندرو	alessandro
أليستير	alistair
أليسوفا	alisova
أليسون	allison
أليسيا	alicia
أليسيو	alessio
أليشا	alesha
أليغييري	alighieri
أليك	alec
أليكا	aleqa
أليكارت	alicarte
أليكزانكو	alexanko
أليكسا	alexa
أليكسز	alexz
أليكسيا	alexia
أليكسيس	alexis
أليمان	aleman
أليماندي	allemandi
ألين	allen
ألينتوفا	alentova
أليندي	allende
ألينغهام	allingham
ألينيكوف	aleinikov
أليو	aliu
أم	umm
أماتو	amato
أمادو	amadou
أمادور	amador
أماديو	amadeo
أماديوس	amadeus
أمار	amar
أمارا	amara
أمارتي	amartey
أماري	amari
أماريا	amarilla
أماسطان	amastan
أمالفيتانو	amalfitano
أمامة	umamah
أمان	aman
أماناتيديس	amanatidis
أماندا	amanda
أمانسيو	amancio
أمانو	amano
أمايا	amaya
أمبارتسوميان	ambartsumian
أمبارو	amparo
أمبان	ambane
أمبروز	ambrose
أمبروزيني	ambrosini
أمبروسيو	ambrosio
أمبير	amber
أمجد	amjad
أمدال	amdahl
أمرشا	amarcha
أمرهاين	amrhein
أمريتا	amrita
أمسيف	amsif
أمشيل	amschel
أمل	amal
أمنحتب	amenhotep
أمندسون	amundson
أمنمحات	amenemhat
أمهالي	amhali
أمو	amo
أمواه	amoah
أموديو	amodio
أموروز	amoros
أموروزو	amoruso
أموسوف	amosov
أموكاتشي	amokachi
أمونيكي	amunike
أميتشي	ameche
أميدي	amedy
أميديار	omidyar
أميرلاي	amiralay
أميري	amiri
أميريكو	americo
أميس	amis
أميليو	amelio
أمين	amin
أمينتاس	amyntas
أميني	amini
أميي	amey
أناتولي	anatoliy
أناستازي	anastasi
أناكون	annacone
أناليس	anneliese
أنان	annan
أنانوس	ananus
أنتوني	anthony
أنتونياده	antoniade
أنتونيسكو	antonescu
أنتونيلو	antonello
أنتونيلي	antonelli
أنتونين	antonin
أنتونيني	antonini
أنتيغونوس	antigonus
أنج	ang
أنجارانو	angarano
أنجر	unger
أنجليس	angelis
أنجليكا	angelica
أنجلينا	angelina
أنجوني	angioni
أنجي	angie
أنجيل	angel
أنجيلا	angela
أنجيلوف	angelov
أنجيليسكو	angelescu
أنجيليكا	anjelica
أنخويلا	anquela
أنخيلينو	angelino
أندرادي	andrade
أندراوس	andraos
أندرس	anders
أندرسون	anderson
أندرسين	andersen
أندرش	andersch
أندرنيكوس	andronicus
أندرو	andrew
أندروبوف	andropov
أندرونيتش	andronic
أندرونيكوس	andronikos
أندروود	underwood
أندرياس	andreas
أندرياسين	andreasen
أندريانوف	andrianov
أندريتش	andric
أندريس	andres
أندريف	andreev
أندريوتي	andreotti
أندريوزي	andreozzi
أندرييف	andreyev
أندويثا	andueza
أندي	andy
أندير	ander
أنديرا	indira
أنس	anas
أنسبش	ansbach
أنسر	unser
أنسل	ansel
أنسلمو	anselmo
أنسيرمت	ansermet
أنسيلين	anselin
أنشريل	ancerl
أنشيتا	anchieta
أنشيك	ancic
أنشيلوتي	ancelotti
أنصاري	ansari
أنصاريفرد	ansarifard
أنطوان	antoine
أنطوانيت	antoinette
أنطون	anton
أنطونين	antonin
أنطونيو	antonio
أنغراند	angrand
أنغوس	angus
أنغولو	angulo
أنكار	anker
أنكان	ankan
أنكفاب	ankvab
أنكه	anke
أنكو	anko
أنكويليتي	anquilletti
أنكي	enki
أنكيتيل	anquetil
أنور	anwar
أنورابي	anuarbe
أنوشكا	anushka
أنوفاتزي	annovazzi
أنويه	anouilh
أنيبالي	annibale
أنيت	annet
أنيتا	anita
أنيتشكين	anichkin
أنيتشيبي	anichebe
أنيس	anis
أنيسة	anissa
أنيستون	aniston
أنيسيه	anicet
أنيل	anil
أنيي	annei
أهرن	ahern
أهرينس	ahrens
أهلستروم	ahlstrom
أهلفورس	ahlfors
أهلي	ahli
أهن	ahn
أهورلو	ahorlu
أهيرن	ahearn
أهيمير	ahimeir
أواكس	oaks
أوال	awal
أوانج	awang
أوباري	opare
أوباسانجو	obasanjo
أوبافيمي	obafemi
أوباما	obama
أوباندو	obando
أوبتز	opitz
أوبرادور	obrador
أوبرانياك	obraniak
أوبري	aubrey
أوبريغون	obregon
أوبلاك	oblak
أوبلانس	o'ballance
أوبنر	hubner
أوبنهايم	oppenheim
أوبوتي	obote
أوبودو	obodo
أوبور	aubour
أوبوميانغ	aubameyang
أوبويل	o'boyle
أوبيانغ	obiang
أوبيرتو	oberto
أوبيرج	oberg
أوبينا	obinna
أوت	ott
أوتا	ota
أوتاكا	utaka
أوتامندي	otamendi
أوتري	autry
أوتريد	oughtred
أوتسكا	otsuka
أوتشس	ochs
أوتل	ottl
أوتليك	ochlik
أوتن	outen
أوتهوف	uhthoff
أوتورياغا	iturriaga
أوتوكار	ottokar
أوتويا	otoya
أوتيت	autet
أوجار	aujjar
أوجلان	ocalan
أوجلثورب	oglethorpe
أوجوست	august
أوجوستين	augustine
أوحادي	ouhadi
أوحيون	ohayon
أودا	oda
أوداباسي	odabasi
أودرا	audra
أودري	audrey
أودني	oudni
أودوارد	audouard
أودونيل	o'donnell
أوديشو	odisho
أوديغارد	ødegaard
أودينكيرك	odenkirk
أور	ur
أوراس	uras
أوراساوا	urasawa
أورانتس	orantes
أوراوا	urawa
أورايلي	o'reilly
أورباخ	auerbach
أوربان	urban
أورباني	urbani
أورباي	orbay
أوربايز	orbaiz
أوربينو	urbino
أوربييتا	urbieta
أورت	oort
أورتر	oerter
أورتيزبيريا	urtizberea
أورتيغا	ortega
أورتيليوس	ortelius
أوردا	orda
أورديناران	urdinaran
أورس	urs
أورسولا	ursula
أورسي	orsi
أورسيني	orsini
أورغوليسكو	iorgulescu
أورلاندو	orlando
أورلاندوني	orlandoni
أورلانديني	orlandini
أورلاي	orley
أورلوفا	orlova
أورليان	orleans
أورويل	orwell
أوريالي	oriali
أوريبي	uribe
أوريديل	uridil
أوريستيس	orestes
أوريكاسا	orikasa
أوريل	aurel
أوريلانا	orellana
أوريليوس	aurelius
أورينجا	orenga
أوريول	oriol
أوزاكي	ozaki
أوزتونالي	oztunalı
أوزفالدو	osvaldo
أوزموند	osmond
أوزوالد	oswald
أوزونلار	uzunlar
أوس	ous
أوسارس	aussaresses
أوساكا	osaka
أوسامو	osamu
أوسان	osann
أوسانو	osano
أوسايل	osael
أوسبرن	osborne
أوسبينا	ospina
أوستابينكو	ostapenko
أوسترم	oostrum
أوستروفسكي	ostrowski
أوستفالد	ostwald
أوستن	austin
أوستويزن	oosthuizen
أوستيا	ostia
أوسفارت	osvart
أوسكار	oscar
أوسكارينو	oscarino
أوسلر	osler
أوسمنت	osment
أوسن	aasen
أوسيتزكي	ossietzky
أوسيلا	osella
أوسيم	osim
أوشاكوف	ushakov
أوشاوا	ohsawa
أوشمان	ochmann
أوشي	o'shea
أوشيروف	osheroff
أوصالح	oussalah
أوطيام	otyam
أوغاتا	ogata
أوغاساوارا	ogasawara
أوغستان	augustin
أوغستو	augusto
أوغستون	ogston
أوغورا	ogura
أوغوستينو	agostinho
أوغونجيمي	ogunjimi
أوفاديا	ovadia
أوفاريل	o'farrell
أوفت	ooft
أوفرمارس	overmars
أوفرمان	offerman
أوفقير	oufkir
أوفنباخ	offenbach
أوفهاوسر	aufhauser
أوكادا	okada
أوكازاكي	okazaki
أوكاس	okkas
أوكاكا	okaka
أوكالاهان	o'callaghan
أوكامبوس	ocampos
أوكاموتو	okamoto
أوكتافيا	octavia
أوكطار	oktar
أوكورو	okoro
أوكوياما	okuyama
أوكي	aoki
أوكيتولا	oketola
أوكيغهيم	ockeghem
أوكينا	okina
أولازار	olazar
أولاس	aulas
أولاف	olaf
أولاند	hollande
أولانو	olano
أولايزولا	olaizola
أولبرمان	olbermann
أولحاج	oulhaj
أولدفيلد	oldfield
أولدمان	oldman
أولر	euler
أولريش	ulrich
أولزابال	olazabal
أولسن	olsen
أولشيفسكي	olszewski
أولغا	olga
أولكر	ulker
أولمان	ullman
أولمرت	olmert
أولمو	olmo
أولموس	olmos
أولميدو	olmedo
أولنبيك	uhlenbeck
أولني	olney
أولوغلن	o'loughlin
أولوف	olof
أوليري	o'leary
أوليغ	oleg
أوليفا	oliva
أوليفاس	olivas
أوليفيراس	oliveras
أولين	olin
أولينجا	olinga
أولينيك	olynyk
أوليوكايف	ulyukaev
أوما	ouma
أومبيرتو	umberto
أومتيتي	umtiti
أوموتويوسي	omotoyossi
أوموزوسي	omozusi
أوميت	umit
أوميرا	omayra
أوميزو	umezu
أونا	oona
أوناسيس	onassis
أونامونو	unamuno
أوناي	unai
أونداما	ondama
أوندروس	ondrus
أونساغر	onsager
أونغاريتي	ungaretti
أونغوريانو	ungureanu
أونفراي	onfray
أونوزوكا	onozuka
أونيانغي	oniangue
أونيشي	onishi
أونيكومب	unicomb
أونيل	o'neil
أوهالرون	o'halloran
أوهانسيان	ohanessian
أوهرين	uhrin
أوهيرا	ohira
أوهيغينز	o'higgins
أوودينداج	oudendag
أووكا	ooka
أووموييلا	owomoyela
أوونا	owona
أووينو	owino
أوي	aoi
أوياجي	aoyagi
أوياما	aoyama
أويدا	ueda
أوير	auer
أويفالوشي	ujfalusi
أويكاني	ujkani
أوين	owen
أوينز	owens
أي	ai
أيا	aya
أيالا	ayala
أيامي	ayami
أيبوي	aiboy
أيتور	aitor
أيديلك	aydilek
أير	eyre
أيرلاند	ireland
أيروبوس	aeropus
أيروسا	airosa
أيرولت	ayrault
أيرونز	irons
أيرونسايد	ironside
أيزاوا	aizawa
أيزاياه	isaiah
أيسريك	eysseric
أيطن	aydın
أيكرويد	aykroyd
أيكنجرون	eichengrun
أيلار	aylar
أيمار	aimar
أيمن	ayman
أيمي	amy
أينشتاين	einstein
أيوزي	ayoze
أيوفي	ayovi
أيومي	ayumi
أييتي	ayite
أييلو	aiello
إباتوف	ipatov
إبارا	ebara
إباغازا	ibagaza
إبراهيم	ibrahim
إبراهيما	ibrahima
إبراهيموف	ibragimov
إبرت	ibert
إبسن	ibsen
إبلنغ	epling
إبنجهاوس	ebbinghaus
إبنيزير	ebenezer
إبوندو	ebondo
إبيرتسبيرغر	ibertsberger
إتريش	ettrich
إتشافاري	echavarri
إتوربيدي	iturbide
إثرينغتون	etherington
إثورالدي	ithurralde
إثيل	ethel
إجناسي	ignasi
إجيرتون	edgerton
إد	ed
إدانغار	idangar
إدريسا	idrissa
إدغاردو	edgardo
إدلفلت	edelfelt
إدموند	edmund
إدنغتون	eddington
إدوار	edouard
إديارتي	idiarte
إديسون	edison
إديلا	adela
إراراغوري	iraragorri
إراكوفيتش	erakovic
إرانييتا	iraneta
إرتل	ertl
إردن	erden
إرسكين	erskine
إرفين	erwin
إركو	erkko
إركولي	ercole
إرل	earl
إرليخ	ehrlich
إرلينغ	erling
إرميا	jeremiah
إرميدا	hermida
إرناندو	hernando
إرنست	ernst
إرنستو	ernesto
إرهولتز	erholtz
إرومويغبي	eromoigbe
إروندي	irwandi
إريا	heriat
إريارتي	iriarte
إريبار	iribar
إريش	erich
إريكسن	eriksen
إزيتا	izzeta
إساكي	esaki
إسبارثا	esparza
إسبرونثيدا	espronceda
إسبرييا	espriella
إسبيل	espil
إسبينار	espinar
إسبينوسا	espinosa
إست	est
إستانغيه	estanguet
إسترادا	estrada
إستفان	istvan
إستيباليث	estibaliz
إستيبان	esteban
إستير	esther
إستيس	estes
إستيلي	estili
إستينو	stino
إسحاق	isaac
إسكتلندا	scotland
إسكوبار	escobar
إسكوديرو	escudero
إسكيدا	esqueda
إسلافا	eslava
إسلام	islam
إسلر	isler
إسماعيل	ismail
إسماعيلوف	izmailov
إسوياما	isoyama
إسياغا	issiaga
إشام	isham
إشراف	echraf
إشفاق	ishfaq
إشمايل	ishmael
إشونك	schwenck
إشيزومي	ishizumi
إغناتز	ignatz
إغناتييف	ignatieff
إغنارو	ignarro
إغنازيو	ignazio
إغناسيو	ignacio
إغناطيوس	ignatius
إغورين	eguren
إفانز	evans
إفرايم	ephraim
إفراين	efrain
إفرمان	everman
إقبال	iqbal
إكدال	ekdal
إكرام	ikram
إكرامي	ekramy
إكيدا	ikeda
إكيرسلي	eckersley
إكينغ	ikeng
إلاري	elleray
إلبردج	elbridge
إلتون	elton
إلجار	elgar
إلروي	elroy
إلستروب	elstrup
إلسي	ilse
إلفورد	elford
إلفيس	elvis
إلفيستروم	elvstrøm
إلكترا	electra
إلكين	elkin
إلم	elm
إلماندر	elmander
إلمر	elmer
إلمور	elmore
إلهام	ilham
إلوفيسكي	illovszky
إليا	ilija
إلياده	eliade
إلياس	elias
إليانور	eleanor
إليجاه	elijah
إليزا	eliza
إليزبيث	elizabeth
إليزوندو	elizondo
إليزي	alesi
إليس	ellis
إليسا	elisa
إليسون	ellison
إليشا	elisha
إلينغتون	ellington
إليهو	elihu
إليوشن	ilyushin
إمباري	mbare
إمبان	empain
إمبو	m'bow
إمره	emre
إملاي	imlay
إمون	emon
إميتيريو	emeterio
إميري	emiri
إميليا	emilia
إميليانو	emiliano
إميليو	emilio
إمينيكي	emenike
إناكي	inaki
إناموتو	inamoto
إنترناشيونال	international
إنجلر	engler
إنجليس	inglis
إنجو	injo
إنجيل	angell
إنجيلبارت	engelbart
إنجيلخيم	ingelgem
إندارا	endara
إندر	ender
إندرا	indra
إندرلان	enderlin
إنده	ende
إندو	endo
إندوراين	indurain
إندومبو	n'doumbou
إندي	indi
إندين	enden
إنرامو	eneramo
إنريكو	enrico
إنزاغي	inzaghi
إنزو	enzo
إنسوا	insua
إنش	ensch
إنصاف	insaf
إنغارامو	ingaramo
إنغالز	ingalls
إنغانغا	n'ganga
إنغروسو	ingrosso
إنغريد	ingrid
إنغلس	engels
إنغلمان	engelmann
إنغمار	ingmar
إنغونغا	engonga
إنغيو	ingyo
إنفالر	einwaller
إنكلمان	enckelman
إنكه	enke
إنكوم	inkoom
إنليل	enlil
إنهوا	enhua
إنهوف	inhofe
إنوكسن	enoksen
إنياما	enyeama
إنيفولدسين	enevoldsen
إنييستا	iniesta
إهرنروت	ehrnrooth
إهرنفست	ehrenfest
إهريت	ehret
إياد	iyad
إيال	eyal
إيان	ian
إيبا	iba
إيباربو	ibarbo
إيباكا	ibaka
إيبان	eban
إيبانيز	ibanez
إيبرت	ebert
إيبرهارت	eberhardt
إيبوكا	ibuka
إيبوليت	hippolyte
إيبوليتا	ippolita
إيبون	aubone
إيبير	hebert
إيتالو	italo
إيتامار	itamar
إيتانجي	itandje
إيتسونا	ietsuna
إيتورالدي	iturralde
إيتوكو	itoku
إيتون	eaton
إيتوهو	etuhu
إيثان	ethan
إيجافيني	ejjafini
إيجلتون	eagleton
إيجيدي	ejide
إيجيرت	eggert
إيدا	ida
إيدانو	edano
إيدبيهي	idbihi
إيدسون	edison
إيدلستام	edelstam
إيدلمان	edelman
إيديلسون	idelsohn
إيراني	errani
إيراولا	iraola
إيرفينج	irving
إيرلز	earles
إيرليتش	erlich
إيرمينيو	herminio
إيرنهارت	earnhardt
إيرول	errol
إيري	airy
إيريكسون	eriksson
إيرين	erin
إيرينا	irina
إيزابيلي	isabeli
إيزاغويره	izaguirre
إيزنمان	eisenman
إيزوكا	iizuka
إيزوكام	ezukam
إيساسا	isaza
إيساكو	eisaku
إيساو	isao
إيستمان	eastman
إيستون	easton
إيستوود	eastwood
إيسر	eyser
إيسلا	isla
إيسنر	eisner
إيسوبي	isobe
إيسوتالو	isotalo
إيسوروكو	isoroku
إيسولا	essola
إيسيان	essien
إيسيدوروس	isidore
إيشا	esha
إيشاوير	eschauer
إيشباخر	aeschbacher
إيشفايلر	eschweiler
إيشنجر	eichinger
إيشيدا	ishida
إيشيرش	escherich
إيشيغه	ieshige
إيشين	isshin
إيشيهارا	ishihara
إيطاليا	italy
إيغاراشي	igarashi
إيغان	egan
إيغلر	eigler
إيغن	eggen
إيغناشيفيتش	ignashevich
إيغيمان	eggimann
إيفار	ivar
إيفارشي	ivarsøy
إيفاريستو	evaristo
إيفازوفسكي	aivazovsky
إيفاشكو	ivashko
إيفالد	ewald
إيفانجلين	evangeline
إيفانجيليستا	evangelista
إيفانشيتز	ivanschitz
إيفانكا	ivanka
إيفانوفسكا	ivanovska
إيفرا	evra
إيفرسون	iverson
إيفل	eiffel
إيفلين	evelyn
إيفورا	evora
إيفولا	evola
إيكازا	icaza
إيكاوا	aikawa
إيكبلود	ekeblad
إيكبيبا	ikpeba
إيكتا	ekta
إيكرمان	eckermann
إيكل	eckel
إيكلاند	ekland
إيكلس	eccles
إيكمان	ekman
إيكهوف	ekhof
إيكونوميديس	economidis
إيلا	ella
إيلاريو	hilario
إيلاس	iles
إيلان	ilan
إيلدوارا	ilduara
إيلرز	eilers
إيلوار	eluard
إيلوري	ilori
إيلوكوبي	elokobi
إيلون	elon
إيليا	elia
إيليماني	ilimane
إيما	emma
إيمان	iman
إيمانويل	emmanuel
إيماي	imai
إيمدن	emden
إيمرتون	emerton
إيملين	emlyn
إيموبيلي	immobile
إيموتو	emoto
إيموري	emori
إيمون	eamon
إيمونز	emmons
إيميت	emmett
إيميتسو	iemitsu
إيميريش	emmerich
إيميلي	emily
إينابا	inaba
إينادا	inada
إينار	einar
إيناكارهير	enakarhire
إيناودي	einaudi
إيناي	inai
إينجيرا	injera
إينجيرير	engerer
إينخنهاوسز	ingenhousz
إينسوورث	ainsworth
إينوبو	ienobu
إينوكي	inoki
إينوها	inoha
إينيس	ennis
إيهارا	ihara
إيهود	ehud
إيواساكي	iwasaki
إيوان	ioan
إيواو	iwao
إييتسوغو	ietsugu
إييسادا	iesada
إييناري	ienari
إييهارو	ieharu
إييوشي	ieyoshi
ابتسام	ibtisam
ابتهال	ibtihal
ابراموفيتش	abramovic
ابنو	ebnou
اتشرلي	etcherelli
اجينا	agena
ادلون	adlon
ادواردز	edwards
ادي	ade
ارابيان	arabian
ارانجيز	aranguiz
ارتشر	archer
ارحومة	rahuma
ارسوي	ersoy
ارسينيو	arsenio
ارلو	arlo
ارميتاج	armitage
ارنهييم	arnheim
ارنو	ernaux
اسبن	aspen
اسشورتر	schurter
اسطمبولي	stambouli
اسكندر	iskandar
اسكولا	escola
اسيس	assis
اشوك	ashok
اعتزاز	aitzaz
اعتماد	etemad
اعمارة	aamara
اغبارية	aghbariyya
افري	avery
افيدون	avedon
اكاسوسو	acasuso
اكساك	aksak
الآتوري	alatorre
الآغا	agha
الآملي	amoli
الأبرش	abrash
الأتاسي	atassi
الأحنف	ahnaf
الأخضر	lakhdar
الأخضري	akhdari
الأديب	adeeb
الأردبيلي	ardabili
الأرسوزي	arsuzi
الأرشيدوق	archduke
الأرقم	arqam
الأرياني	iryani
الأزهر	lazhar
الأزور	azwar
الأسعد	asaad
الأسمري	asmari
الأسواني	aswany
الأشتر	ashtar
الأصفهاني	isfahani
الأطرش	atrash
الأطروش	utrush
الأعرج	araj
الأعرجي	araji
الأفطس	aftas
الأكفاني	akfani
الألشي	ulshi
الألفي	alfi
الأنسي	onsi
الأوخريدي	ohrid
الأيهم	aiham
الإحقاقي	ihqaqi
الإسكندري	alexandria
الإسلامبولي	islambouli
الاجدابي	ajdabi
الاختيار	ikhtiyar
الاسفزاري	isfizari
البابطين	babtain
الباجه	pachachi
البارقي	bariqi
البارودي	baroudi
الباري	bari
البان	baan
البانو	albano
الببلاوي	beblawi
البتاني	battani
البتيري	albutairi
البحرة	bahra
البدران	badrani
البدواوي	badwawi
البرازيل	brazil
البراك	barrak
البرت	albert
البرتغال	portugal
البرغش	alـbarghash
البرقان	bargan
البركي	barki
البريك	breik
البسطويسي	bastawisy
البشاري	beshari
البشتاوي	bashtawi
البشتي	bishti
البعداني	baadani
البغدادي	baghdadi
البكاء	albakaa
البلادي	biladi
البلخي	balkhi
البلكرامي	bilgrami
البناني	bennani
البنبي	banbi
البنزرتي	benzarti
البنشيري	banshiri
البوران	alboran
البوصافي	busafy
البوفلاسة	albuflasa
البولاني	bulani
البوني	buni
البياضي	elbaiady
البيثيني	bithynia
البيروني	biruni
البيزنطي	byzantium
البيشي	bishi
البيضاوي	baydawi
البيطار	bitar
التاجر	tajer
الترابي	turabi
التكرلي	tikerly
التلميذ	tilmidh
التمياط	temyat
التونجي	tunji
التويجري	tuwaijry
التيرس	alters
التيزاني	tizani
التيفاشي	tifashi
التيماوي	temawi
التيمورية	taymur
الثمالي	thumali
الثوري	thawri
الجار	jarallah
الجارحي	elgarhi
الجاف	jaff
الجبري	jabry
الجربا	jarba
الجربي	jerbi
الجزائرية	jazairia
الجضران	jadhran
الجلاوي	jallawi
الجموح	jamuh
الجناحي	janahi
الجهادي	jihadi
الجهم	jahm
الجهمي	eljahmi
الجواري	jawari
الجودر	jowder
الجوهر	johar
الجياب	yayyab
الجيرسواري	alguersuari
الجيلاني	gilani
الجيلي	jili
الحارث	harith
الحازمي	hazmi
الحاسي	hassi
الحبسي	habsi
الحبشي	hebshi
الحديابية	adiabene
الحرار	elharar
الحروب	hroub
الحشاش	hashash
الحشان	hashan
الحصري	hussary
الحفار	haffar
الحلاج	hallaj
الحلبي	halabi
الحليم	halim
الحمرا	hamra
الحمروش	hamroush
الحميد	hamid
الحميدان	humaidan
الحوراني	hawrani
الحويج	alomar
الخائن	hain
الخاتمی	khatami
الخادم	hadım
الخازني	khazini
الخال	khal
الخالد	khalid
الخثران	khathran
الخجا	khouja
الخرافي	kharafi
الخشت	elkhosht
الخطيب	khatib
الخفاجي	khufaji
الخلال	khallal
الخولاني	khawlani
الدارمي	darimi
الداري	dari
الدايري	dairi
الدايم	abduldaim
الدباشي	dabbashi
الدراني	durrani
الدريهم	durayhim
الدقباسي	daqbaashi
الدكالي	doukkali
الدماطي	eldamaty
الدنمارك	denmark
الدهب	dhahab
الدواليبي	dawalibi
الدوخي	dokhi
الدولاتلي	doulatli
الدولة	dawla
الدويسان	duwaisan
الذياب	thyab
الراوندي	rawandi
الرباح	rabbah
الرباع	rabbae
الرباعي	roubai
الرحمن	rahman
الركابي	rikabi
الرياشي	riyashi
الرياضي	ryadi
الريمي	raymi
الزاخر	zakher
الزبون	zboun
الزبير	zubayr
الزرن	zran
الزغبي	zoghbi
الزغدودي	zaghdoudi
الزمان	zaman
الزهاوي	zahawi
الزهراني	zahrani
الزهرة	zahra
الزوايد	zawayed
الزوري	zori
الساحلي	sahli
السادات	sadat
الساقزلي	sakizli
السان	alassane
السباخي	sobakhi
السبحاني	sobhani
السبزواري	sabzavari
السحيمات	suheimat
السخاوي	sakhawi
السرسك	sarsak
السرفاتي	serfaty
السرهندي	sirhindi
السقاف	saqqaf
السلال	sallal
السلام	salam
السلامين	elsalameen
السليمان	suleiman
السمان	samman
السماهيجي	samahiji
السمح	samh
السمني	elsamni
السهارنفوري	saharanpuri
السواح	sawwah
السويحلي	asswehly
السيابي	siyabi
السيروان	seirawan
السيستاني	sistani
الشاب	cheb
الشاطبي	shatibi
الشاعر	shaer
الشامسي	shamsi
الشايبي	chaibi
الشبستري	shabistari
الشبول	shboul
الشحي	shehhi
الشدياق	shidyaq
الشغري	sheghri
الشفاء	shifa'
الشقاقي	shaqaqi
الشمراني	shamrani
الشميري	shameri
الشنتف	elshantaf
الشهبندر	shahbandar
الشهراني	shahrani
الشهرزوري	shahrazuri
الشهري	shehri
الشوا	shawwa
الشوادفي	shwadfy
الشورابي	chourabi
الشوشان	shushan
الشيب	sheeb
الشيخ	sheikh
الشيخي	sheikhi
الشيرواني	shirvani
الشیخ	shaykh
الصابئ	sabi'
الصابوري	alsaboory
الصادق	sadiq
الصافي	safi
الصبار	essabar
الصبان	sabban
الصدر	sadr
الصفار	saffar
الصقري	saqri
الصلح	solh
الصلوي	selwi
الصناني	esnany
الصيدوني	sidon
الضابط	dhabit
الضاري	dhari
الضحاك	dahak
الضياف	diyaf
الطحاوي	eltahawy
الطرابلسي	trabelsi
الطراروة	altararwah
الطراونة	tarawneh
الطيباوي	tibawi
الظافر	zafir
الظلمي	dolmy
الظهراني	dhahrani
العابد	abid
العادل	adil
العارف	aref
العاضد	adid
العاطي	ati
العاني	abdulsalam
العايدي	alaidy
العبار	alabbar
العتيق	ateeq
العثيمين	uthaymeen
العجب	agab
العجلاني	ajlani
العجلوني	ajlouni
العديم	adim
العرب	arab
العرجاوي	arjaoui
العرعور	aroor
العرفاوي	larfaoui
العريف	arif
العريّض	laarayedh
العساف	assaf
العسري	lasri
العسقلاني	asqalani
العسلي	asali
العضايلة	adaileh
العطاس	attas
العطية	attiyah
العظم	azm
العكايشي	akaichi
العلاقي	allagui
العلمي	alami
العماري	lamari
العمور	amour
العنابي	annabi
العناني	anani
العنصر	laenser
العوضات	awadat
العولقي	awlaki
العيادي	ayadi
العيدروس	aydarus
الغابد	algabid
الغافقي	ghafiqi
الغالب	ghalib
الغانمي	ghanmi
الغرسي	gharsi
الغزال	ghazzal
الغزالي	ghazali
الغشمي	ghashmi
الغماري	ghumari
الغندور	ghandour
الغوانمة	ghawanmeh
الفارابي	farabi
الفارض	farid
الفراتي	fourati
الفردان	fardan
الفقار	zulfikar
الفقيه	faqih
الفليج	alflaij
الفهري	fihri
الفهمي	fahmi
الفورتية	fortia
الفوزان	fawzan
الفياض	fayadh
الفيتوري	fituri
الفيلالي	filali
القاسم	qasim
القاسمى	qasimi
القاضي	qadi
القدوة	qudwa
القذافي	gaddafi
القرا	karra
القرمانلي	karamanli
القسري	qasri
القسطلاني	qastallani
القصاص	kassas
القضاعي	abbar
القطان	qattan
القطراني	qetrani
القطريب	katrib
القفطي	qifti
القلال	kallel
القلانسي	qalanisi
القنطاري	kantari
الكاتب	alkateb
الكاس	kass
الكاشاني	kashani
الكالاي	alkalai
الكامل	kamil
الكبرى	elder
الكثيري	kathiri
الكحال	kahhal
الكربولي	karbouly
الكسندر	alexander
الكشميري	kashmiri
الكلاباذي	kalabadhi
الكلبي	kalbi
الكمالي	kamali
الكندي	kindi
الكنزاري	kanzari
الكوراني	kourani
الكوكباني	kokabany
الكوني	koni
اللاحم	lahim
اللبواني	labwani
اللطيف	latif
الله	abdullah
اللوزي	lawzi
الماغوط	maghut
المالك	abdelmalek
المانع	mana
المثلوثي	mathlouthi
المجالي	majali
المجريطي	majriti
المجيد‎	abdulmajid
المحارمة	maharmeh
المحاسبي	muhasibi
المحسن	muhsin
المحضار	mihdhar
المحمودي	mahmudi
المحيا	muhaya
المحيشي	muhayshi
المختاري	mokhtari
المخزنجي	makhzangi
المدب	meddeb
المرابط	lamrabet
المراشي	marashi
المراغي	maraghi
المرداسي	mirdasi
المزغني	mezghanni
المساري	messari
المساكني	msakni
المسترشد	mustarshid
المستعصم	musta'sim
المستعصمي	musta'simi
المستكفي	mustakfi
المستمسك	mustamsik
المستنجد	mustanjid
المستيري	mestiri
المشعان	mashaan
المشهداني	mashhadani
المشهدي	mashhadi
المطغري	matghari
المعاني	maani
المعتمد	mu'tamid
المعشر	muasher
المعيقلي	mueaqly
المعينا	maeena
المغسل	mughassil
المقبالي	muqbali
المقتدر	muqtadir
المقريزي	maqrizi
المناري	mnari
المنتشري	montashari
المنتصر	muntasir
المنتظري	montazeri
المنجرة	elmandjra
المنسي	mansi
المنفلوطي	manfaluti
المنكدر	munkadir
المنلا	munla
المنيف	munif
المهدوي	almhadoui
المهدي	mahdi
المواس	maowas
المواوي	mwawi
المياح	mayah
المياغري	lamyaghri
الميرغني	mirghani
الميكاري	mikari
النايض	nayed
النبي	abdelnaby
النخلي	alnakhli
النديم	nadim
النسور	ensour
النضر	nadr
النعمان	nu'man
النفطي	nafti
النفيس	nafis
النقاش	naqqache
النقيدان	nogaidan
النمش	namash
النهاوندي	nahavandi
النورسي	nursi
النونو	nono
النيسابوري	nishapuri
الهتار	hattar
الهراوي	hrawi
الهمامي	hammami
الهمذاني	hamadani
الهوى	abulhawa
الهيبة	hiba
الهيشري	hichri
الوائلي	waeli
الواثق	wathiq
الواريتي	ouariti
الوافي	wafi
الورياغلي	ouaraghli
الوزان	wazzan
الوسلاتي	oueslati
الوطواط	vatvat
الياسمين	yasamin
اليزدي	yazdi
اليسون	alison
الينسون	allinson
اليونسي	elyounoussi
امارال	amaral
امارو	amaro
امتياز	imtiaz
امقاسم	amqassim
اميل	emile
ان	ann
انجلوند	englund
انجوس	anjos
اندروس	andrus
اندريتي	andretti
اندريه	andrei
انزكو	inzko
انطوي	antwi
انغرام	ingraham
انغليرت	englert
اوتربريج	outerbridge
اوتليه	otlet
اوخلوبيستين	okhlobystin
اودان	audin
اور	oar
اورينتريك	orentreich
اوسيلفيان	o'sullivan
اوعيسى	oaissa
اولمو	oulmou
اوم	om
اومالي	o'malley
اومانا	umana
اوموت	umut
اونيروكيو	oniroku
ايبيتارن	hebuterne
ايروين	irwin
ايزواردي	isoardi
ايزينبايفا	isinbayeva
ايسترن	estrin
ايستومين	istomin
ايغلبرغر	eagleburger
ايفانا	evanna
ايكبرج	ekberg
ايلاريا	ilaria
ايلزورث	aylesworth
ايميه	ayme
اينشتاين	weinstein
اينيس	innis
ايواني	iwane
ايوب	ayoub
بآسيلينا	paasilinna
بآسيو	paasio
بابا	baba
باباجان	babacan
بابادوبولو	papadopulo
بابار	babbar
بابارت	pappaert
باباريزو	paparizou
باباس	papas
باباكولي	papakouli
باباندريو	papandreou
بابانيكولاو	papanikolaou
بابتيست	baptiste
بابتيستا	baptista
بابك	babak
بابكوك	babcock
بابن	papen
بابنجيدا	babangida
بابوريلي	barbirolli
بابوشكين	babochkin
بابون	baboun
بابيت	babbitt
بابيج	babbage
بابيس	papiss
بابينسكي	babinski
بات	pat
باتا	batta
باتابير	batabaire
باتاغلين	battaglin
باتاكي	pataky
باتريسيا	patricia
باتريسيو	patricio
باتريك	patrick
باتزايكين	patzaichin
باتساتزوغلو	patsatzoglou
باتسي	patsy
باتش	patch
باتشيلبيل	pachelbel
باتن	patten
باتنبرغ	battenberg
باتوكا	patocka
باتوم	batum
باتون	patton
باتيرنوستر	paternoster
باتيستا	batista
باتيستون	battiston
باتيستي	battisti
باتينسون	pattinson
باثان	bazan
باثوري	bathory
باجاني	pagani
باجت	paget
باجداتيس	baghdatis
باجمال	bajamal
باجندوح	bajandouh
باجو	baggio
باجي	bajirao
باجيتنوف	pajitnov
باجيس	pagis
باحمدان	bahamdan
باخشوين	bakshween
باخوم	bakhoum
باخون	pajon
باخوير	bachauer
بادالكي	padalecki
بادالينو	padalino
بادج	budge
بادجو	badjou
بادجي	badji
بادروس	padros
بادزاني	bazzani
بادن	baden
بادواي	padway
بادور	badoer
بادوفاني	padovani
بادوين	padoin
بار	parr
باراجيس	parages
باراخا	baraja
بارادي	paradis
باراغان	barragan
بارال	barral
بارالت	baralt
بارامزينا	baramzina
باران	baran
بارانتيس	barrantes
بارانسكي	baranski
باراهونا	barahona
باربازا	barbazza
باربر	barber
باربر	barbour
باربرا	barbara
باربريني	barberini
باربوس	barbusse
باربي	barbie
بارترا	bartra
بارترينا	bartrina
بارتز	bartz
بارتشيل	baruchel
بارتلي	bartali
بارتوك	bartok
بارتول	bartol
بارتولدي	bartholdi
بارتولوتشي	bartolucci
بارتولوميه	bartolome
بارتوميو	bartomeu
بارتون	barton
بارتيك	bartik
بارث	barth
بارثلم	barthelme
بارثولوميو	bartholomew
بارثيل	barthel
بارجافيل	barjavel
بارد	bard
باردسلي	bardsley
باردم	bardem
باردي	pardee
بارديزا	pardeza
باردين	bardeen
باردينياس	pardinas
بارزالي	barzagli
بارفانوف	parvanov
بارفيت	parfitt
بارك	park
باركا	barca
باركر	parker
باركلا	barkla
باركلي	barkley
باركنسون	parkinson
باركيلو	barrichello
باركين	barkin
بارلاخ	barlach
بارلاس	barlas
بارلو	barlow
بارلوزي	barluzzi
بارلي	barley
بارمبي	barmby
بارنابي	parnaby
بارنس	barnes
بارنوم	barnum
بارني	barney
بارنيتي	parineeti
بارنيل	parnell
باروتشي	barocci
باروخ	baruch
باروس	barros
باروسو	barroso
باروش	baros
بارولا	parola
بارولو	parolo
بارون	baron
باريا	barea
باريت	barrett
باريتي	parietti
باريخا	pareja
باريدهي	paridhi
باريديس	paredes
بارير	barrier
باريرا	barrera
باريزون	barison
باريس	paris
باريش	parrish
باريشنيكوف	baryshnikov
باريل	burrell
باريمور	barrymore
بارينبويم	barenboim
بارينو	barreno
باريه	pare
باريو	barrio
باريوس	barrios
بازركان	bazargan
بازوليني	pasolini
بازين	bazin
بازينزا	pazienza
باس	bass
باساريلا	passarella
باسانتا	basanta
باسانن	pasanen
باساني	bassani
باسبي	busby
باستا	basta
باستر	buster
باسترناك	pasternak
باستريش	pastreich
باستل	pastal
باستن	basten
باستو	basto
باستور	pastor
باستوري	pastore
باستيا	bastiat
باستيانيش	bastianich
باستير	pasteur
باسرمان	bassermann
باسك	busk
باسكاكوف	baskakov
باسكال	pascal
باسكوال	pascual
باسكوالي	pasquale
باسكواليتي	pasqualetti
باسكوالينو	pasqualino
باسكوف	baskov
باسلر	basler
باسندوة	basindawa
باسنوا	busnois
باسوف	basov
باسولكو	pasulko
باسيانا	basiana
باسيانوس	passianos
باسيفيتش	bacevich
باسيل	basil
باسيلا	bassila
باسيلو	passello
باسيلي	bassily
باشا	pasha
باشام	basham
باشانسكي	pasanski
باشايي	pashaei
باشكيرتسيف	bashkirtseff
باشلار	bachelard
باشوليا	pachulia
باشوليي	bachelier
باشير	beshear
باصهي	basuhai
باغ	bague
باغايوكو	bagayoko
باغراميان	bagramyan
باغنيس	bagnis
باغيميل	bagemihl
بافاريا	bavaria
بافت	buffett
بافل	pavel
بافليوتشينكو	pavlyuchenko
بافول	pavol
بافولوفا	pavlova
بافون	pavon
بافيلتشينكو	pavlichenko
باقر	baqir
باقري	bagheri
باكاري	bakary
باكال	bacall
باكالا	bakala
باكاي	bakaye
باكرو	bacrot
باكستر	baxter
باكستون	paxton
باكسندل	baxendale
باكشال	backshall
باكشي	bakshi
باكل	buckle
باكهاوس	backhaus
باكوس	backus
باكولا	bakula
باكونين	bakunin
باكوين	paquin
بالا	balla
بالابان	balaban
بالاتينات	palatine
بالادينو	palladino
بالاديو	palladio
بالاسيو	palacio
بالاسيوس	palacios
بالاشوف	balashov
بالبو	balbo
بالبوا	balboa
بالبيلوس	balbilus
بالتا	balta
بالتازار	balthasar
بالتيسبيرجير	baltisberger
بالتييف	baltiev
بالداتشي	baldacci
بالداساري	baldassarri
بالدو	baldo
بالدوليني	baldolini
بالدوين	baldwin
بالديفييزو	baldivieso
بالديني	baldini
بالريش	belraysh
بالزاريتي	balzaretti
بالزو	balzo
بالزين	bezzine
بالسامو	balsamo
بالش	balch
بالله	al
بالما	palma
بالمر	palmer
بالمه	palme
بالمونت	balmont
بالنزياغا	balenziaga
بالنسيا	palencia
بالوبينسكاس	palubinskas
بالوتا	ballotta
بالوتاش	palotas
بالوتاي	palotai
بالوجينا	palaiologina
بالوسكي	paloschi
بالومبو	palumbo
بالومو	palomo
بالون	palun
بالويي	baloyi
باليتا	paletta
باليتش	balitsch
باليز	bales
باليستر	pallister
باليستيروس	ballestrero
باليما	balima
بالين	palin
بالينجير	ballinger
باليوني	baglioni
بالييتش	baljic
بامبا	bamba
بامبارا	bambara
بامبيانكو	pambianco
بامبيرجر	bamberger
باموغو	bamogo
باموق	pamuk
باميلا	pamela
بانا	bana
باناباكر	panabaker
باناتين	bannatyne
بانان	bannan
بانانا	banana
بانتاني	pantani
بانتنغ	banting
بانتوليانو	pantoliano
بانتير	panettiere
بانتيليتش	pantelic
بانجو	banjo
بانجورا	bangura
باندا	banda
باندر	pander
باندلر	bandler
باندورا	bandura
باندولف	pandulf
باندولفو	pandolfo
باندي	bande
بانديراس	banderas
بانديرولا	bandirola
بانديف	pandev
باندينولف	pandenulf
بانديون	pandion
بانر	banner
بانرمان	bannerman
بانزا	panza
بانشو	pancho
بانكاريل	bancarel
بانكراتوفا	pankratova
بانكروفت	bancroft
بانكس	banks
بانكسيكس	pancsics
بانوف	panov
بانيا	bagnaia
بانياني	pagnani
بانيتا	panetta
بانيرو	panero
بانيس	panis
بانيستر	bannister
بانيشفسكي	banishevskiy
بانينكا	panenka
بانيني	panini
بانيول	pagnol
باها	baha
باهامونتيس	bahamontes
باهر	bahr
باهرو	bahro
باهو	bahu
باهور	pahor
باهيبيك	bahebeck
باود	baude
باوش	pausch
باولنغ	pauling
باولينا	paulina
باولينو	paulino
باوليني	paolini
باومغارتنر	baumgartner
باوميوهان	baumjohann
باويل	powell
بايا	baia
بايانو	baiano
بايتون	peyton
بايدن	biden
بايراموفيتش	bajramovic
بايرد	baird
بايرو	bayrou
بايريتو	pairetto
بايزا	baeza
بايزلي	paisley
بايزيد	bayezid
بايقال	baykal
بايلوت	paillot
بايلي	bailey
بايليس	bayliss
باين	bain
باينتر	paynter
باينيماراما	bainimarama
بترو	petrou
بتروفا	petrova
بتري	petri
بتريوس	petraeus
بتلر	butler
بتيبا	petipa
بثرك	petherick
بجاوي	bedjaoui
بجلي	bigley
بحاح	bahah
بحاري	bahari
بحراني	bahrani
بحنيني	bahnini
بخاتي	bakhati
بختيار	bakhtiar
بختیاري	bakhtiarizadeh
بدة	badda
بدران	badran
بدراوي	badrawi
بدرة	badra
بدرية	badreya
بدور	bodour
بدوم	beddome
بدوي	badawi
براء	bara
براباشي	barabasi
برابن	braben
برابهام	brabham
برابيندير	brabender
برات	pratt
براتشي	bracci
براتشيت	pratchett
براجانزا	braganza
براد	brad
برادبري	bradbury
برادر	baradar
برادشو	bradshaw
برادفورد	bradford
برادلي	bradley
برادوس	prados
برادوك	braddock
برادي	brady
براسكو	brasco
براشيه	brachet
براشييلي	bracciali
براغ	bragg
براغولين	bragolin
براف	braff
برافو	bravo
براكام	barcham
براكامونتاس	bracamontes
براكستون	braxton
براليا	braglia
برام	bram
برامبيا	brambilla
برامس	brahms
برامهار	braamhaar
براناه	branagh
براند	brand
براندز	brands
براندل	brundle
براندنبورغ	brandenburg
براندو	brando
براندون	brandon
برانديز	brandeis
برانر	brenner
برانسون	branson
برانسويجك	brunswijk
برانش	branch
برانكو	branko
برانيتي	brannetti
برانيجان	branigan
برانيسلاف	branislav
براهمي	brahmi
براهني	baraheni
براهيمي	brahimi
براوخيتش	brauchitsch
براون	brown
براونسون	brownson
براونشفايغ	brunswick
براونلي	brownlee
برايا	praia
براياند	briand
برايتمان	brightman
برايتنجر	breitinger
برايزات	braizat
برايم	briem
براينت	bryant
برباتوف	berbatov
بربري	barberi
بربولا	parpola
برتاجيا	bertaggia
برترام	bertram
برتسل	pretzl
برتش	bertsch
برتشتولد	berchtold
برتولوتشي	bertolucci
برتوليه	berthollet
برتينشو	burtenshaw
برتيني	pertini
برجان	barrajan
برجس	burgess
برجسون	bergson
برجشتال	purgstall
برخا	barkha
برخد	barkhad
برد	burd
بردويل	bridewell
بردي	janbirdi
برديس	brudes
برزان	barzan
برزوالسكي	przhevalsky
برزيسكي	brzezicki
برس	behrs
برسكي	briski
برسلين	breslin
برسني	barsane
برسيفال	perceval
برشلونة	barcelona
برشلينو	bercellino
برشيانو	bresciano
برصوم	barsoum
برغر	berger
برغرين	berggreen
برغمان	bergman
برغماير	burgmeier
برغن	burgon
برقلين	bergelin
بركات	barakat
بركديش	bergdich
بركلياتشا	brkljaca
بركوس	berkous
برلسكوني	berlusconi
برلنت	berlant
برلنتي	berlenti
برلينر	berliner
برلينغوير	berlinguer
برمان	berman
برمة	brimah
برمك	barmak
برمودو	bermudo
برناردو	bernardo
برنال	bernal
برناوي	barnawi
برنتانو	brentano
برندان	brendan
برنز	burns
برنسايد	burnside
برنستاين	bernstein
برنستروم	bernstrom
برنشلي	brenchley
برنهارد	bernhard
برنيولا	perniola
برهامي	borhamy
برهان	burhan
برهم	barham
برهوم	barhom
بروتشارد	brochard
بروتن	braaten
بروتوس	brutus
بروتون	bruton
بروجينك	bruggink
بروخروف	prokhorov
بروخوف	broekhoff
برودبنت	broadbent
برودس	brodus
برودفود	broadfoot
برودنت	prudente
برودهوم	preud'homme
برودوم	prudhomme
بروس	bruce
بروسبيرين	prosperin
بروستر	brewster
بروسك	brosque
بروسنيكينا	brusnikina
بروسيا	prussia
بروسيلوف	brusilov
بروسينسكي	brosinski
بروش	brosh
بروغلي	broglie
بروغيرا	bruguera
بروفاروني	brovarone
بروفنزانو	provenzano
بروك	brooke
بروكاو	brokaw
بروكدين	brockden
بروكس	brooks
بروكلمان	brockelmann
بروكيلين	breukelen
برولين	brolin
بروما	bruma
برومانا	brumana
بروميس	promes
برون	bron
برونتي	bronte
برونزيني	bronzini
برونس	bruns
برونستد	brønsted
برونستين	bronstein
برونسون	bronson
برونك	pronk
برونكهورست	bronckhorst
برونليسكي	brunelleschi
برونوفسكي	bronowski
برونوين	bronwyn
بروني	bruni
برونياو	bruneau
برونيرو	brunero
برونينغ	bruning
بروهن	bruhn
بروويكمان	broekman
بروياس	proyas
برويتش	broich
برويز	pervez
برويسارت	broissart
بروينسا	proenca
برياسون	bryson
بريان	brian
بريانكا	priyanka
بريتاني	brittany
بريتشارد	pritchard
بريتن	britten
بريتو	brito
بريتوس	britos
بريجز	briggs
بريجنيف	brezhnev
بريدا	preda
بريدج	bridge
بريدجيت	bridget
بريديسين	bredesen
بريرادوفيتش	preradovic
بريريتون	brereton
بريز	breeze
بريزان	prezan
بريزيتش	brzic
بريس	press
بريستلي	priestley
بريستون	preston
بريسكوت	prescott
بريسل	presl
بريسلي	presley
بريسونيك	bresonik
بريش	brych
بريغي	brighi
بريفال	preval
بريفت	privat
بريفن	previn
بريفيا	badea
بريفيك	breivik
بريكين	breckin
بريلانتي	brillante
بريلهانتي	brilhante
بريلوغ	prelog
بريلوم	soderblom
بريمر	bremer
بريمنغر	preminger
بريمو	primo
برينا	brianna
برينان	brennan
برينتس	prinz
برينجاس	bringas
برينجل	brengle
بريند	brande
بريندل	brendell
برينديرغاست	prendergast
برينغيلا	berengaria
برينكلي	brinkley
برينمان	brenneman
برينيس	brenes
بزي	bazzi
بسايح	bessaih
بستالوتزي	pestalozzi
بستاني	boustany
بسخاني	pasikhani
بسمارك	bismarck
بسنتي	pesenti
بسيسو	bseiso
بشرى	bushra
بشير	bashir
بصري	basry
بطارسة	batarseh
بطاطو	batatu
بطلان	butlan
بطوطة	battuta
بعلة	baala
بعيرة	baira
بغ	bugg
بغدادليان	baghdadlian
بفاف	pfaff
بفانكوتش	pfannkuch
بفلوغلر	pflugler
بفيرتزل	pfertzel
بفيس	bevis
بفيستر	pfister
بفينينجير	pfenninger
بقالي	bakkali
بقرادوني	pakradouni
بقنه	bugnah
بك	bey
بكا	pekka
بكداش	bakdash
بكر	bakr
بكرجيكلو	bakircioglu
بكري	bakri
بكنباور	beckenbauer
بكير	bekir
بل	bell
بلا	pellat
بلات	platt
بلاتزر	platzer
بلاتيني	platini
بلاثا	plaza
بلاز	bellaz
بلازيفيتش	blazevic
بلاسكيت	plaskett
بلاسم	blasim
بلاسيس	blasiis
بلاسينتي	placente
بلاسينجيم	blassingame
بلاش	blache
بلاشيل	plasil
بلاطة	boullata
بلاغا	blaga
بلاغوي	blagoje
بلافاتسكي	blavatsky
بلافريج	balafrej
بلاك	black
بلاكبيرن	blackburn
بلاكسلاند	blaxland
بلاكلي	blackley
بلاكويل	blackwell
بلاكيستون	blakiston
بلامر	plummer
بلامين	plamen
بلان	blanc
بلانا	plana
بلانتشفيلد	blanchfield
بلانشار	blanchard
بلانشون	planchon
بلانشي	blanche
بلانك	blank
بلانكا	blanche
بلانكو	blanco
بلانكيت	plunkett
بلانكينستاين	blankenstein
بلانوس	planus
بلانيتشكا	planicka
بلاورايت	plowright
بلاي	bligh
بلاياك	blayac
بلاير	player
بلايك	blake
بلايند	blind
بلتران	beltran
بلتزر	blitzer
بلتشر	bletcher
بلتيمور	baltimore
بلتيير	peltier
بلج	balj
بلحاج	benhadj
بلحسن	belhassen
بلحوت	belhout
بلحوس	balhous
بلد	blood
بلزاك	balzac
بلسترم	billstrom
بلسم	balsam
بلص	balass
بلعربي	bellarabi
بلغاريا	bulgaria
بلغران	belgrand
بلغريف	belgrave
بلغريني	pellegrini
بلغول	belghoul
بلقايد	belkaid
بلقولة	belqola
بلقين	buluggin
بلكايد	belgaid
بلكسين	blixen
بلمختار	belmokhtar
بلموندو	belmondo
بلهام	pelham
بلهي	bulleh
بلو	blue
بلوخ	bloch
بلوخين	blokhin
بلودجود	bloodgood
بلولة	baloola
بلوم	bluhm
بلوم	blum
بلومارت	bloemaert
بلومبيرغ	bloomberg
بلومفيلد	bloomfield
بلومكامب	blomkamp
بلوملي	plumlee
بلومنتال	blumenthal
بلوندو	blondeau
بليافسكي	beliavsky
بليدة	balideh
بليدز	blades
بليري	belleri
بليز	blaise
بليزينسكي	bleszinski
بليستان	plestan
بليستسكايا	plisetskaya
بليسيت	blissett
بليسيرز	plessers
بليسين	plessen
بليغ	baligh
بليكس	blix
بليمنز	plemons
بلين	blaine
بلينيوس	pliny
بن	ibn
بناك	pennac
بناهي	panahi
بنت	bint
بنتام	bentham
بنتر	pinter
بنتسيل	paintsil
بنتوف	bentov
بنتي	pentti
بنتيفوليو	bentivoglio
بنتيكي	benteke
بنتين	bentin
بنتينغ	bunting
بنجر	banjar
بنجلون	benjelloun
بنحاس	pinchas
بندتسون	bendetson
بندر	bandar
بندكت	benedict
بندي	bundy
بنزية	benzia
بنش	bunche
بنعبد	benabdallah
بنعلي	benali
بنعمر	benomar
بنفورد	benford
بنفينوتي	benvenuti
بنكوست	pancoast
بنمنصور	benmansour
بنهيمة	benhima
بنوت	bannout
بنوزة	benouza
بنولي	pnueli
بنيام	binyam
بنيامينو	beniamino
بنيان	bunyan
بنيت	jonbenet
بنيتو	benneteau
بنيس	bennis
بهات	bhatt
بهادر	bahadur
بهادراني	bahadorani
بهار	bahar
بهجت	bahjat
بهرنغ	behring
بهمن	bahman
بهنام	bahnam
بهنود	behnoud
بهوي	bahoui
بهيجة	bahija
بو	bo
بواتينغ	boateng
بواردي	baouardy
بوارنيه	beauharnais
بواس	boas
بواشامب	beauchamp
بواكيه	boakye
بوانكاريه	poincare
بوب	bob
بوبا	bouba
بوباديلا	bobadilla
بوبانا	bopanna
بوبرنيك	bubernik
بوبروفسكي	bobrowski
بوبريكوف	bobrikov
بوبكا	bubka
بوبكر	boubacar
بوبكري	boubakri
بوبليل	boublil
بوبليه	buble
بوبوكين	bubukin
بوبي	bobby
بوبير	beaubier
بوتا	botta
بوتاسو	botasso
بوتجر	bottger
بوتر	potter
بوتراغينيو	butragueno
بوتسر	bauzer
بوتسين	boutsen
بوتشكوفا	puchkova
بوتشه	buche
بوتشولز	buchholz
بوتفنيك	botvinnik
بوتلر	beutler
بوتليروف	butlerov
بوتنام	putnam
بوتنان	botnen
بوتنانت	butenandt
بوتنتسيفا	putintseva
بوتنر	buttner
بوتو	bhutto
بوتور	butor
بوتيا	botia
بوتيتشيلي	botticelli
بوتيرو	botero
بوتيريل	botterill
بوتيل	butelle
بوتينا	putina
بوتينزا	potenza
بوث	booth
بوجدانوف	bogdanov
بوجدرة	boudjedra
بوجسيم	bujsaim
بوجلبان	boujelbene
بوجناح	boujenah
بوحاجب	bouhageb
بوخارت	bochart
بوخارين	bukharin
بوخفالت	buchwald
بوخلوه	buchloh
بوخيمة	boukhima
بودا	boda
بودار	boudard
بودالانوسكي	pudzianowski
بودري	baudry
بودريار	baudrillard
بودكوبايفا	podkopayeva
بودلير	baudelaire
بودمر	bodmer
بودمير	buddemeyer
بودن	bowden
بودنيتز	budnitz
بوده	bode
بودوان	baudouin
بودي	buddy
بوديانيسكي	budyanskiy
بوذا	bauza
بورا	bora
بوراك	burak
بوربيرار	pourpirar
بوربيرهارت	purperhart
بورت	burt
بورتا	porta
بورتاس	portas
بورتاقو	portago
بورتانت	portante
بورتانوفا	portanova
بورتر	porter
بورتسامبارك	portzamparc
بورتشيرت	burchert
بورتفليت	poortvliet
بورتوغيزي	portoghesi
بورتولا	portola
بورتين	burton
بورجا	borgia
بورجس	burges
بورخا	borja
بوردا	borda
بورداج	bordage
بوردمان	boardman
بوردن	borden
بورديسو	burdisso
بورديو	bourdieu
بوردييه	bordier
بورزاني	borzani
بورزيج	borzage
بورسا	borsa
بورساتش	bursac
بورست	borst
بورسوي	borsoi
بورسياني	borciani
بورسيلينو	borsellino
بورشبيرج	borschberg
بورشردس	borcherds
بورشغرفنك	borchgrevink
بورعليغنجي	pouraliganji
بورغ	borg
بورغاد	bourgade
بورغكمير	burgkmair
بورغندي	burgundy
بورغنين	borgnine
بورغين	bourgain
بورفيريو	porfirio
بورقيبة	bourguiba
بورك	burke
بوركرت	burkert
بوركي	burki
بوركيل	burkill
بورلاوج	borlaug
بورم	boorem
بورنر	borner
بورنه	borne
بورهافا	boerhaave
بورو	boru
بورودين	borodin
بوروسيس	bourousis
بورول	burwell
بوريتسو	buretsu
بوريدج	burridge
بوريس	boris
بوريفوج	borivoj
بوريل	borel
بوريلي	borrelli
بوريني	borini
بوزاتي	buzzati
بوزانكيت	bosanquet
بوزانيتش	bozanic
بوزدنياكوف	pozdnyakov
بوزر	boozer
بوزفور	bouzfour
بوزور	puzur
بوزيد	bouzid
بوزيدي	bouzidi
بوساداس	posadas
بوساكا	busacca
بوستامانتي	bustamante
بوستة	bousta
بوستوس	bustos
بوسطيلة	boustila
بوسعيد	boussaid
بوسعيدي	boussaidi
بوسكاليا	buscaglia
بوسكامب	boskamp
بوسكوسكورو	boscoscuro
بوسكوفيتش	boskovic
بوسكي	bosque
بوسكيتس	busquets
بوسكيسوليدو	peschisolido
بوسمان	bosman
بوسنيتش	bosnich
بوسورث	bosworth
بوسويل	buswell
بوسيجور	beausejour
بوسيس	bossis
بوسيل	bussell
بوسينغوا	bosingwa
بوسيني	busini
بوسيو	bossio
بوش	bush
بوشار	bouchard
بوشارب	bouchareb
بوشاردو	bouchardeau
بوشكو	bosko
بوشناق	bouchnak
بوشوك	bouchouk
بوشير	boucher
بوشيمي	buscemi
بوشينجر	bauschinger
بوصوف	boussouf
بوضياف	boudiaf
بوطالب	boutaleb
بوعافية	bouafia
بوعب	bouab
بوعلام	boualem
بوعوزان	bouaouzan
بوغاتي	baghetti
بوغارت	bogart
بوغافاتش	bogavac
بوغالو	bugalo
بوغبا	pogba
بوغنفيل	bougainville
بوغوسكي	boguski
بوغوليوبوف	bogolyubov
بوغينسكايا	boginskaya
بوفا	bova
بوفالا	pofalla
بوفانو	buffalo
بوفراند	boffrand
بوفورت،	beaufort
بوفي	boffi
بوكاري	boukari
بوكانيغرا	bocanegra
بوكتشين	bookchin
بوكريشكين	pokryshkin
بوكريني	boccherini
بوكمال	bukamal
بوكمينستر	buckminster
بوكور	bucur
بوكوفا	bokova
بوكوفسكي	bukowski
بوكي	bookie
بوكير	bucker
بوكيلا	bokila
بولاتكان	polatkan
بولاتي	bolatti
بولاسي	bolasie
بولاط	bolat
بولامي	boulami
بولانسكي	polanski
بولانفلييه	boulainvilliers
بولانيك	palahniuk
بولانيو	bolano
بولانيوس	bolanos
بولانيي	polanyi
بولبي	bowlby
بولتزمان	boltzmann
بولتمان	bultmann
بولتون	bolton
بولدري	baldry
بولدين	bolden
بولز	bowles
بولزانو	bolzano
بولزوني	bolzoni
بولسن	poulsen
بولسون	paulson
بولعنصر	boulainceur
بولعيد	benboulaid
بولغار	polgar
بولغاكوف	bulgakov
بولغر	bolger
بولفوني	bulfoni
بولفينش	bulfinch
بولكانين	bulganin
بولكينغهورن	polkinghorne
بولمان	pullman
بولناراف	polnareff
بولنتير	pollentier
بولنغر	bollinger
بولوف	bulow
بولوك	bullock
بولياسينو	bogliacino
بوليان	buljan
بوليتزر	pulitzer
بوليتكوفسكايا	politkovskaya
بوليتيري	bollettieri
بوليدو	pulido
بوليف	boulif
بوليكن	bulykin
بوليهستر	polyhistor
بوما	bouma
بومارشيه	beaumarchais
بومان	bowman
بومباردا	bombarda
بومبارديني	bombardini
بومبوناتزي	pomponazzi
بومبيري	bombieri
بومعزة	boumaaza
بومنجل	boumendjel
بومول	baumol
بومونت	beaumont
بوميل	bommel
بونا	bona
بونابرت	bonaparte
بونارت	bonnart
بونانوتي	buonanotte
بونتا	ponta
بونتوبيدان	pontoppidan
بونتون	bunton
بونتيس	pontes
بونخي	bunge
بوندارتشوك	bondarchuk
بوندز	bonds
بوندورانت	bondurant
بونر	bonner
بونرد	bonnard
بونزي	ponzi
بونزيو	ponzio
بونس	pons
بونسيل	ponselle
بونصو	ponsot
بونغ	bong
بونغارتز	bongartz
بونغويلا	binguila
بونغيرت	bungert
بونفوا	bonnefoy
بونفيل	bonville
بونفيليو	bonfiglio
بونفين	bonvin
بونك	bunke
بونكراشوف	ponkrashov
بونهوف	bonhof
بونهوفر	bonhoeffer
بونوماريوف	ponomariov
بونومي	bonomi
بونويل	bunuel
بوني	bonnie
بونياتوسكا	poniatowska
بونياتوفسكي	poniatowski
بونياكو	bunjaku
بونياكوفسكي	bunyakovsky
بونيرا	bonera
بونيزوني	bonizzoni
بونيشيا	bonechea
بونيك	boniek
بونيلا	bonilla
بونين	bunin
بونينج	bonynge
بونيه	bonnet
بوهجانبالو	pohjanpalo
بوهلر	bohler
بوهلين	bohlin
بوهورز	bouhours
بوهوركيث	bohorquez
بوو	bow
بوي	bowie
بوي	boye
بويا	boya
بوياردو	boiardo
بويان	bojan
بويبوض	bouyboud
بويتوس	boetius
بويتينغر	peutinger
بويد	boyd
بويرو	buero
بويسون	buisson
بويغرينيير	puygrenier
بويغيس	buigues
بويل	boyle
بويمي	buemi
بوين	bowen
بوينس	boyens
بوينغ	boeing
بوينو	bueno
بوينيش	boenisch
بويو	buyo
بيابياني	biabiany
بياتريس	beatrice
بياتريكس	beatrix
بياجي	biaggi
بياساس	biyiasas
بياغيانتي	biagianti
بيافا	biava
بياله	piali
بيانشوتي	bianciotti
بيانكا	bianca
بيانكو	bianco
بيانكي	bianchi
بياو	biao
بيباشا	bipasha
بيبرون	bibron
بيبل	bejbl
بيبو	bebo
بيبيك	bebek
بيتان	petain
بيتانا	pitana
بيتاني	bettany
بيتاو	pitau
بيتر	peter
بيترا	petra
بيترجيلا	petrzela
بيترسون	peterson
بيترش	bittrich
بيتركين	peterkin
بيتروس	pietrus
بيتروف	petrov
بيتروني	petrone
بيترونيلا	petronilla
بيترويبا	pitroipa
بيتري	petre
بيتريا	petria
بيتزوزيرو	bizzozero
بيتزيغ	betzig
بيتس	bates
بيتسون	bateson
بيتشمان	bechmann
بيتكار	patekar
بيتلين	bethlen
بيتمان	bateman
بيته	bethe
بيتهوفن	beethoven
بيتور	benbitour
بيتول	pitol
بيتولا	petula
بيتيا	beitia
بيتيغا	bettega
بيتيفر	pettyfer
بيتيل	petel
بيتيناتو	pettinato
بيثل	bethel
بيجبيديه	beigbeder
بيجرام	pegram
بيجليا	biglia
بيجوتات	bijotat
بيخار	bejar
بيخشستاين	pechstein
بيداتسو	bidatsu
بيدرسن	pedersen
بيدرو	pedro
بيدروسا	pedrosa
بيدريتي	pedretti
بيدس	beidas
بيدي	bedi
بيديمو	bedimo
بيديمونتي	pedemonte
بيدينيك	bedenik
بيرابو	perabo
بيرالبا	peralba
بيران	perrin
بيرانديلو	pirandello
بيرانك	beranek
بيرانيزي	piranesi
بيرباج	burbage
بيرباوم	bierbaum
بيرت	bert
بيرتا	bertha
بيرتشيتشي	berchiche
بيرتن	bertin
بيرتولاتشي	bertolacci
بيرتولو	bertolo
بيرتوليني	bertolini
بيرتوني	bertoni
بيرتيلسن	bertelsen
بيرتيني	bertini
بيرثود	berthod
بيرثيل	perthel
بيرثيلسين	berthelsen
بيرجاماشي	bergamaschi
بيرجانزا	berganza
بيرجسون	bergeson
بيرجيرون	bergeron
بيرد	bird
بيردسلي	beardsley
بيردن	burdon
بيردو	perdue
بيردونيه	perdonnet
بيرديكاس	perdiccas
بيردييف	berdiyew
بيرر	berrer
بيرستون	burston
بيرسول	peirsol
بيرسي	percy
بيرسيوس	perseus
بيرطو	berto
بيرغ	berg
بيرغارا	bergara
بيرغر	burger
بيرغفولد	bergvold
بيرغن	bergen
بيرغوليزي	pergolesi
بيرغومي	bergomi
بيرغونيو	bergougnoux
بيرغيرو	bergeroo
بيرغيسيو	bergessio
بيرغيوس	bergius
بيرفيلي	berville
بيركارد	burckhard
بيركامب	bergkamp
بيركمان	berkman
بيركن	perkin
بيركنز	perkins
بيركهولدر	burkholder
بيركوس	berkus
بيركوف	berkoff
بيركين	birkin
بيرلمان	perlman
بيرلموتر	perlmutter
بيرلو	pirlo
بيرليس	perlis
بيرلينسكي	berlinski
بيرليوز	berlioz
بيرموديز	bermudez
بيرميخو	bermejo
بيرنابي	bernabe
بيرناديت	bernadette
بيرنارد	bernard
بيرنارديز	bernardez
بيرنارديلو	bernardello
بيرناك	bernac
بيرنانديس	bernardes
بيرنباوم	birnbaum
بيرنت	burnett
بيرند	bernd
بيرنر	berner
بيرنرز	berners
بيرنولي	bernoulli
بيرنيا	pernia
بيرنيز	bernays
بيرهوف	bierhoff
بيروت	perot
بيروتا	perrotta
بيروز	peroz
بيروفانو	pirovano
بيرون	perron
بيروني	pironi
بيريتز	peretz
بيريدا	pereda
بيريرا	pereira
بيريرينها	pereirinha
بيريز	perez
بيريزوفسكي	berezovsky
بيريسفورد	beresford
بيريف	beriev
بيرينجر	berenger
بيرينديرو	berrendero
بيرينيل	perrinelle
بيريوكوف	biriukov
بيزاروسي	pezzarossi
بيزان	pizan
بيزنت	besant
بيزوس	bezos
بيزولانو	pezzolano
بيزي	pezzey
بيزيك	peszek
بيزيمونغو	bizimungu
بيسارودونا	pesarrodona
بيسانيا	pecanha
بيسبرس	pispers
بيستر	bester
بيستروف	bystrov
بيستشاستنخ	beschastnykh
بيستوني	pistone
بيسكارولو	pescarolo
بيسلي	beasley
بيسوا	pessoa
بيسويو	besoiu
بيسي	bisse
بيش	bysshe
بيشتاين	bechstein
بيشل	peschel
بيشوشكين	pichushkin
بيشوف	bischoff
بيشوفتس	byshovets
بيشيرسكي	pechersky
بيشيل	bishil
بيضائي	beyzai
بيغ	big
بيغارد	begard
بيغاس	bigas
بيغام	biggam
بيغلو	bigelow
بيغونيو	bigogno
بيغي	peggy
بيفان	bevan
بيفرلي	beverly
بيفنز	bevins
بيفوفاروفا	pivovarova
بيك	beck
بيكارد	piccard
بيكاردو	piccardo
بيكاريك	pekarik
بيكالي	becali
بيكر	baker
بيكرنج	pickering
بيكروفت	beecroft
بيكسبي	bixby
بيكسل	bichsel
بيكسيا	beccia
بيكفورد	pickford
بيكم	bechem
بيكمامبيتوف	bekmambetov
بيكمانس	beekmans
بيكماييف	bikmaev
بيكنيل	bicknell
بيكهارت	pekhart
بيكهام	peckham
بيكوي	bekoe
بيكويث	beckwith
بيكيت	beckett
بيكينسيل	beckinsale
بيل	bill
بيلارد	bellard
بيلاغان	beligan
بيلامي	bellamy
بيلانكا	bellanca
بيلاي	belay
بيلتز	peltz
بيلجر	pilger
بيلجرين	pellegrin
بيلروت	billroth
بيلز	beals
بيلزر	belzer
بيلسا	bielsa
بيلغوي	pilguy
بيلفورت	belfort
بيلفيس	bellvis
بيلمونتي	belmonte
بيلوتي	belote
بيلود	pillud
بيلوسو	peluso
بيلوشي	belushi
بيلوف	bellof
بيلوني	bellone
بيلي	billy
بيليرانو	pellerano
بيليسي	bellisi
بيليغرينو	pellegrino
بيليما	belima
بيلين	belen
بيليندورف	behlendorf
بيلينغز	billings
بيلينغير	belenguer
بيلينكوسو	belencoso
بيليني	bellini
بيليون	bellion
بيم	pim
بيمبر	pember
بيمبرتون	pemberton
بيمل	behmel
بيمينوفا	pimenova
بينا	pena
بينات	benat
بينار	pınar
بيناسيدو	benasedo
بينافيل	penafiel
بينال	pinal
بيناليو	benaglio
بينايفا	pinayeva
بينبن	benben
بينت	bent
بينتنر	bendtner
بينتي	penty
بينتيليه	pintilie
بينجامين	benjamin
بيندر	bender
بيندليتون	pendleton
بينر	boehner
بينزينج	benzing
بينست	binst
بينسنت	pinsent
بينسون	benson
بينشون	pynchon
بينغبينغ	bingbing
بينغتسون	bengtsson
بينغويشيا	bengoechea
بينغيل	pengel
بينكا	benka
بينكر	pinker
بينكرتون	pinkerton
بينكستون	pinkston
بينل	pinel
بينهاكر	beenhakker
بينوا	benoit
بينور	binnur
بينوسي	benussi
بينوش	binoche
بينولا	pinola
بيني	benny
بيني	penny
بينيت	bennett
بينيتو	benito
بينيتي	benetti
بينيتيز	benitez
بينيديك	benedek
بينيسن	benenson
بينيلوس	pinillos
بينيني	benigni
بينيه	binet
بينيوف	benioff
بينييس	pinies
بيهان	behan
بيهريندورف	behrendorff
بيهن	behn
بيهي	behe
بيوتروفسكي	piotrovsky
بيوركمان	bjorkman
بيورلين	bjorlin
بيورون	buron
بيورين	buren
بيوكانان	buchanan
بيولا	piola
بيوليز	boulez
بيونتيك	piontek
بيوندتي	biondetti
بيوندي	biondi
بيونديني	biondini
بيونغ	byung
بييترو	pietro
بینسكر	pinsker
ت.	t.
تاباري	tabare
تابان	tappan
تابلادا	tablada
تابو	tabu
تابوردا	taborda
تابيثا	tabitha
تاتستا	tatsuta
تاتسهيسا	tatsuhisa
تاتسوهيكو	tatsuhiko
تاتسويا	tatsuya
تاتشر	thatcher
تاتو	tautou
تاتوم	tatum
تاتي	tati
تاتيانا	tatyana
تاتيشفيلي	tatishvili
تاجليوني	taglioni
تاجيري	tajiri
تاداناري	tadanari
تاداهيرو	tadahiro
تاداو	tadao
تادرس	tadros
تادي	taddei
تاديوش	tadeusz
تارا	tara
تارانغو	tarango
تاربيل	tarbell
تاردوزي	tardozzi
تارديو	tardieu
تاركويني	tarquini
تارلوف	tarlov
تاروفي	taruffi
تاريك	tarik
تاسفاوت	tasfaout
تاسمان	tasman
تاسوتي	tassotti
تاسوس	tassos
تاسين	tassin
تاشفين	tashfin
تاشلين	tashlin
تاعرابت	taarabt
تاغو	tagoe
تاغييف	taguieff
تافاري	tavernier
تافاريس	tavares
تافانو	tavano
تافت	taft
تافيري	taveri
تاكاأكي	takaaki
تاكازومي	takazumi
تاكاشي	takashi
تاكاغي	takagi
تاكاموري	takamori
تاكانوري	takanori
تاكايا	takaya
تاكاياما	takayama
تاكايوكي	takayuki
تاكتاروف	taktarov
تاكر	tucker
تاكستون	thaxton
تاكوشي	takeuchi
تاكوما	takuma
تاكومي	takumi
تاكوني	tacconi
تاكويا	takuya
تاكيشي	takeshi
تاكيني	taquini
تاكيهيكو	takehiko
تاكيو	takeo
تالامونتي	talamonti
تالبوت	talbot
تالكوت	talcott
تالمون	talmon
تالي	talley
تاليسا	talisa
تامادا	tamada
تامار	tamar
تاماركين	tamarkin
تاماشي	tamassy
تاماكي	tamaki
تاماميس	tamames
تامبو	tambo
تامبور	tambor
تامبورا	tamboura
تامر	tamer
تامودو	tamudo
تامورا	tamura
تاميت	tammet
تامير	tamir
تان	tan
تاناسي	tanase
تاناهاشي	tanahashi
تانجي	tandja
تاندا	taneda
تانسلي	tansley
تانكريد	tancred
تانكريدو	tancredo
تانكو	tunku
تاني	tani
تانيا	tania
تاهان	tahan
تاوب	taube
تاوت	taut
تاورس	towers
تاوفآهاو	taufaʻahau
تاونسيند	townsend
تايجو	taejo
تايجونغ	taejong
تايرا	tyra
تايسون	tyson
تايشو	taisho
تايك	taik
تايلر	tyler
تايلور	taylor
تايمازوف	taymazov
تايهو	taiho
تبعمرانت	tabaamrant
تتاريسكو	tattarescu
تتسو	tetsu
تته	tetteh
تجار	tedjar
تجاردا	tjaarda
تجويدي	tajvidi
تحوتمس	thutmose
تحية	tahia
تديما	alma
تراب	turab
تراباتوني	trapattoni
ترابين	tarabin
تراسلو	truslow
تراش	trasch
ترافا	traba
ترافاليو	travaglio
ترافولتا	travolta
ترافيرس	travers
ترافيس	travis
ترامب	trump
ترامل	trammell
تراميوتولا	tramutola
تراميول	tramiel
تران	tran
تراني	trani
تراوري	traore
ترايلور	traylor
ترايير	trier
تربل	terbil
تركان	turkcan
تركي	turki
ترنبول	turnbull
ترنتينيان	trintignant
ترنر	turner
ترنس	terrence
تروبنسكي	torbinski
تروبيل	troupel
تروتسكي	trotsky
تروتشيت	truchet
تروخوفسكي	trochowski
ترودو	trudeau
تروست	trost
تروسيرو	trossero
تروسيلير	trousselier
تروشو	trochu
تروفو	truffaut
ترومان	truman
ترومب	trombe
ترومبيك	trumbic
ترومبيلدور	trumpeldor
ترونغ	truong
تروني	trenet
تروي	troy
ترويا	troyat
ترويسكي	troicki
ترويسي	troisi
تري	trey
تريانا	triana
تريتشيكوف	tretchikoff
تريثيموس	trithemius
تريجو	trejo
تريزيغيه	trezeguet
تريستان	tristan
تريسكوامر	tresckow
تريسي	tracy
تريشكوفا	tereshkova
تريغ	treg
تريفور	trevor
تريفولوني	trefoloni
تريفيثيك	trevithick
تريكة	aboutrika
تريليس	trelease
تريمر	trimmer
تريموليناس	tremoulinas
ترين	train
ترينكر	trenker
ترينور	treanor
تريو	triaud
تزارا	tzara
تزونيس	tzonis
تسابل	zabel
تسارالازا	tsaralaza
تساريف	tsaryov
تسانغ	tsang
تسجيتاني	tsujitani
تسركليه،	tserclaes
تسفانغيراي	tsvangirai
تسفيتايفا	tsvetaeva
تسوبورايا	tsuburaya
تسوبوي	tsuboi
تسوتومو	tsutomu
تسوجي	tsuji
تسوجيمورا	tsujimura
تسوجيهارا	tsujihara
تسوخارت	zuchardt
تسورايوكي	tsurayuki
تسورو	tsuru
تسوكماير	zuckmayer
تسومرا	tsumura
تسونايوشي	tsunayoshi
تسيترلينغ	zetterling
تسيرميلو	zermelo
تسيمبالار	tsymbalar
تشا	cha
تشابارو	chaparro
تشاباييف	chapayev
تشابلن	chaplin
تشابمان	chapman
تشاتلوش	catlos
تشاتو	tchato
تشاد	chad
تشادويك	chadwick
تشاربينيت	charpenet
تشاردينا	scardina
تشارنر	scharner
تشارنلي	charnley
تشارنيتسكي	czarniecki
تشازاريني	casarini
تشاس	chas
تشافر	schafer
تشافولا	chavula
تشاكفيتادزه	chakvetadze
تشال	schall
تشالانا	chalana
تشالفي	chalfie
تشالك	chalke
تشالمرز	chalmers
تشالهان	calhanoglu
تشامانغا	chamanga
تشامبرز	chambers
تشامبرلين	chamberlain
تشامبلن	champlin
تشاموت	chamot
تشامورو	chamorro
تشان	chan
تشانتراين	chantraine
تشانتريل	chantrel
تشانج	chang
تشاندا	chanda
تشانديا	chandia
تشانراويناتا	chandrawinata
تشانس	chance
تشانسا	chansa
تشانسلور	chancellor
تشانو	ciano
تشانوف	chanov
تشانيليت	chanelet
تشايان	cayan
تشايس	chase
تشايلد	child
تشرنياخوفسكي	chernyakhovsky
تشرنين	chernin
تشستر	chester
تشلاودراف	schlaudraff
تشمران	chamran
تشنغجونغ	chungjeong
تشنغموك	chungmok
تشنغن	cheng'en
تشنيبيرغر	schneeberger
تشوا	chua
تشواب	schwaab
تشوان	quan
تشواي	chuai
تشوبرا	chopra
تشوخراي	chukhray
تشودري	chaudhry
تشورتش	schorch
تشوردا	chorda
تشوكارين	chukarin
تشوكوو	chukwu
تشولتز	schultz
تشومي	tschumi
تشونغ	chung
تشونغهيون	jeonghyeon
تشياكي	chiaki
تشيبا	chiba
تشيبرفيلد	chipperfield
تشيت	chet
تشيتالو	chitalu
تشيتي	tchite
تشيجوسا	chigusa
تشيخايدزة	chkheidze
تشيخوفا	chekhova
تشيرجلاند	churchland
تشيرش	church
تشيروندولو	cherundolo
تشيري	cherry
تشيريبنين	tcherepnin
تشيريشيف	cheryshev
تشيسلينكو	chislenko
تشيسنال	chisnall
تشيشولم	chisholm
تشيغاريني	cigarini
تشيفكا	cywka
تشيفيديني	chividini
تشيكا	checa
تشيكلس	chiklis
تشيلافيرت	chilavert
تشيلر	chyler
تشيلنتانو	celentano
تشيماروزا	cimarosa
تشيمبوندا	chimbonda
تشيمومولي	chimomole
تشيمينتو	chimento
تشيمينتي	chimenti
تشينتو	chintu
تشيندزيلورز	schindzielorz
تشينوويث	chenoweth
تشيني	cheney
تشيهيرو	chihiro
تشيوا	chiwa
تعاسة	ta'asa
تغري	taghribirdi
تغلب	taghlib
تفيت	tveit
تفيرسكي	tversky
تقي	taqi
تقية	takeyh
تك	teck
تكوتين	ticotin
تمارا	tamara
تمبست	tempest
تنغ	teng
تننباوم	tenenbaum
تواتي	touati
توارت	twort
توالا	thwala
توامكين	tiomkin
توبمان	tubman
توبن	tobin
توبوسو	toboso
توبوف	tubœuf
توبي	toby
توبياس	tobias
توبيانسكي	tobianski
توتاني	totani
توتشي	tochi
توتشيكا	tochika
توتو	tutu
توتوري	totori
توتي	totti
توجان	toujan
توخولسكي	tucholsky
تودت	todt
تودور	tudor
توديتشيني	todeschini
توديك	tudyk
تورادو	torrado
توراسي	taurasi
توراكينا	toregene
تورام	thuram
توران	turan
توربرن	torbern
توربكه	thorbecke
تورجمان	turgeman
تورجي	torje
تورستن	torsten
تورسنوف	tursunov
تورسيوس	turcios
تورشتفت	thorstvedt
تورغيلي	torghelle
تورف	torv
توركماني	turkmani
توركواتو	torcuato
تورنج	turing
تورنس	torrence
تورو	toro
تورول	turul
تورى	tori
توريالبا	torrealba
تورياما	toriyama
توريبيونج	toribiong
توريخوس	torrijos
توريخون	torrejon
توريومي	toriumi
توز	touze
توسان	toussaint
توسيلاند	toseland
توشار	tusshar
توشيكو	toshiko
توشيكي	toshiki
توشيهيرو	toshihiro
توشيو	toshiro
توشيوكي	toshiyuki
توشييا	toshiya
توغاشي	togashi
توفاتي	tovati
توفار	tovar
توفت	toft
توفر	topher
توكاريف	tokarev
توكوتو	tokoto
توكورو	tokuro
توكوغاوا	tokugawa
توكي	toucey
تولاسن	tulasne
تولالان	toulalan
تولبوخين	tolbukhin
تولتشيف	tallchief
تولدي	toldi
توللر	toller
توليفر	tolliver
تولين	tulin
توما	toma
توماسو	tommaso
توماش	tomas
توماني	toumani
تومبا	tomba
تومبالباي	tombalbaye
تومباو	tombaugh
تومبكنز	tompkins
تومكنز	tomkins
تومكو	tomko
توملن	tomlin
توملينسون	tomlinson
تومو	tomo
توموجي	tomoji
توموسابورو	tomosaburo
توموكازو	tomokazu
توموياسو	tomoyasu
تومويو	tomoyo
تومويوكي	tomoyuki
تومي	tommy
توميسلاف	tomislav
تونبرغ	thunberg
توندو	tondo
تونسي	tounsi
تونغ	tong
تونكوف	tonkov
توني	tony
تونيتو	tonetto
توياما	toyama
تويتي	twitty
تويلمان	twellman
توين	twain
تويو	toyo
تويوساكي	toyosaki
تويوغتشي	toyoguchi
تويوناغا	toyonaga
تيا	tea
تياسي	tiasse
تياغو	thiago
تيان	tianhua
تيبر	teber
تيبساريفيتش	tipsarevic
تيبل	tepl
تيبور	tibor
تيبوني	tiboni
تيبيتس	tibbets
تيبيريوس	tiberius
تيبيلسكيرخ	tippelskirch
تيت	tate
تيتس	tits
تيتسويا	tetsuya
تيتش	titsch
تيتشه	tesche
تيتوس	titus
تيتيما	titima
تيجاني	tijani
تيخادا	tejada
تيخيرا	tejera
تيد	ted
تيدير	tedder
تيرادوس	tirados
تيرازاكي	terasaki
تيرازينو	terrazzino
تيراسوما	terasoma
تيراشيما	terashima
تيرالا	tyrała
تيربيتز	tirpitz
تيرزي	terzi
تيرسو	tirso
تيرمشكان	tirimujgan
تيرندل	triendl
تيرني	tierney
تيروزي	teruzzi
تيري	terry
تيريس	tyrese
تيريشنكو	tereshchenko
تيريو	terrio
تيزدايل	teasdale
تيزي	tizie
تيستي	testi
تيسديل	tisdale
تيسوني	tissone
تيسيليوس	tiselius
تيشا	tisha
تيشلر	tishler
تيغانا	tigana
تيغوشي	tegoshi
تيغيلين	tiggelen
تيفاني	tiffany
تيفيز	tevez
تيفين	tiffin
تيلار	teilhard
تيلدن	tilden
تيلر	teller
تيلليني	tellini
تيلمان	tillman
تيله	thile
تيلو	telo
تيليس	telles
تيليكي	teleki
تيمانوف	taimanov
تيمبرلك	timberlake
تيمبل	temple
تيمر	timmer
تيمو	timo
تيموثي	timothy
تيموشوك	tymoshchuk
تيموفتي	timofti
تيمونير	timoner
تيمية	taymiyyah
تين	taine
تينا	tina
تينار	thenard
تينان	tynan
تينانت	tennant
تينبرغن	tinbergen
تينبي	tenpei
تينتو	tinto
تينجي	tenji
تيندال	tyndale
تينديلو	tendillo
تينكو	tenco
تينلي	thinley
تينموث	tinmouth
تينهان	tinhan
تينوريو	tenorio
تينوكو	tinoco
تينيسي	tennessee
تيهاو	tehau
تيودوريك	theuderic
تيودوسيو	teodosio
تيورل	theorell
تيوفيلو	teofilo
تيولينيف	tyulenev
تييري	thierry
ثابت	thabit
ثابو	thabo
ثاتشي	thaci
ثاديوس	thaddeus
ثالبرج	thalberg
ثاندي	thandie
ثاني	thani
ثاير	thayer
ثريا	soraya
ثريلفول	threlfall
ثمامة	thumamah
ثوايت	thwaite
ثورب	thorpe
ثورستون	thurston
ثورغيرسون	thorgerson
ثورفالد	thorvald
ثورن	thorne
ثورنبيرغ	thornburg
ثورنتون	thornton
ثوروس	thoros
ثوريك	thariq
ثولوت	tholot
ثوم	thom
ثومسون	thomson
ثون	thon
ثونن	thunen
ثيا	thea
ثيادورا	theodora
ثيبو	thepot
ثيتشوسين	thychosen
ثيربانتس	cervantes
ثيروكس	theroux
ثيري	thierree
ثيرينغ	thiering
ثيسن	thissen
ثيسيجر	thesiger
ثيسين	thijssen
ثيكي	thicke
ثيلما	thelma
ثيم	thiem
ثيودور	theodore
ثيودوسيوس	theodosius
ثيوديبيرت	theudebert
ثيون	theon
جاباري	jabari
جاباي	gabai
جابر	jaber
جابرييلي	gabrieli
جابلونسكي	jablonsky
جابويلي	jabouille
جابيس	jabes
جابيكا	gabica
جابيني	gabini
جاتوي	jatoi
جاجارين	gagarin
جاجيك	gajic
جاد	gad
جادون	gadon
جارثي	garci
جارجو	jarju
جارديل	gardell
جارزيلي	garzelli
جارفيس	jarvis
جارمان	jarmann
جارنز	garns
جارنيل	jarnell
جارو	jarreau
جارود	jarrod
جاريك	garrick
جاريوت	garriott
جازيريا	gazzera
جاسبارد	gaspard
جاسباروتو	gasparotto
جاسباريان	gasparyan
جاست	just
جاستالديلو	gastaldello
جاستون	gaston
جاستيس	justice
جاسمي	jassem
جاسندي	gassendi
جاسول	gasol
جاسي	jassy
جاسيرون	jasseron
جاغر	jager
جاغيلكا	jagielka
جاف	jaffe
جافل	gavel
جاك	jack
جاكار	jacquard
جاكلين	jacqueline
جاكمان	jackman
جاكموت	jacmot
جاكوب	jacob
جاكوبس	jacobs
جاكوتيه	jaccottet
جاكي	jackie
جالابير	jalabert
جالبرايث	galbraith
جالدوس	galdos
جالوب	gallup
جاليت	jallet
جالينا	gallina
جاليناري	gallinari
جاما	gama
جامب	jump
جامباتيستا	giambattista
جامبل	gamble
جامبون	gambon
جاموف	gamow
جامي	jami
جاميتشال	jamychal
جان	jean
جانت	gantt
جاندوبو	jeandupeux
جانسين	janssen
جانغ	jang
جانغريول	jangnyeol
جانغيونغ	janggyeong
جانك	junck
جانكلفتش	jankelevitch
جانلوكا	gianluca
جانلويجي	gianluigi
جانمات	janmaat
جانيت	janet
جانيريه	jeanneret
جانيسيو	janicio
جانيني	giannini
جانيوري	january
جاهير	jahier
جاهين	jahin
جاود	jawed
جاوي	jawai
جاي	jay
جايبل	geibel
جايتون	guyton
جايسي	jaycee
جايلورد	gaylord
جاين	jane
جاينور	gaynor
جباري	jabbari
جبرا	jabra
جبرتي	ghiberti
جبريل	jibril
جبلة	jabalah
جبيريل	djibril
جت	jet
جتير	jeter
جثين	gethin
جحش	jahsh
جحفلي	jahfali
جدانوفيتش	zhdanovich
جدت	judt
جدي	jdey
جراغ	jarragh
جرافنبرج	grafenberg
جراميجني	gramigni
جراناث	granath
جراندي	grandi
جرانفيل	granville
جراهام	graham
جراي	grey
جرهارد	gerhardt
جروبيلار	grobbelaar
جروتول	grotewohl
جروتيوس	grotius
جروسيتيست	grosseteste
جرونمير	gronemeyer
جروه	groh
جريتزكي	gretzky
جريجسون	gregson
جريجوري	gregory
جريخالبا	grijalva
جرير	jarir
جريصاتي	jreissati
جريفوس	gryphius
جريفيث	griffith
جريلو	grillo
جريمالدي	grimaldi
جريماو	grimau
جرين	greene
جرينبلات	greenblatt
جرينسبان	greenspan
جرينسلاد	greenslade
جرينيت	greenert
جزلة	jazla
جستنيان	justinian
جستين	justin
جطو	jettou
جعرون	jarun
جعيم	juaim
جغام	jegham
جفين	jufain
جك	jik
جكير	cakır
جلادويل	gladwell
جلازر	glaser
جلايسون	gleason
جلجل	juljul
جلعاد	gilad
جلوي	jiluwi
جلويد	jlloyd
جليبوفا	glebova
جليدون	gliddon
جليزر	glazer
جليلة	jalila
جليلي	jalili
جلين	glenn
جلينياداكيس	glyniadakis
جم	cem
جمال	jamal
جمرا	jamra
جمشيديان	jamshidian
جميل	jamil
جن	jin
جناتي	jannaati
جناح	jinnah
جنبلاط	jumblatt
جنتون	gunton
جنتيلي	gentile
جنجر	ginger
جندال	jindal
جندب	jundab
جندريكار	chundrigar
جندلي	jandali
جندو	jendo
جنغجونغ	jungjong
جنكس	jencks
جنيد	junaid
جنيسيس	genesis
جنيفر	jennifer
جنين	janine
جهاد	jihad
جهان	jahan
جو	joe
جوادي	djawadi
جوارين	guarin
جوال	jawwal
جوانا	joanna
جوانفيل	joinville
جواو	joao
جوبرت	jobert
جوبلن	joplin
جوبير	joubert
جوبيك	jopek
جوبيند	gobind
جوتشد	gottsched
جوتليب	gottlieb
جوتوديا	djotodia
جوخدار	jokhadar
جودار	jodar
جودت	jawdat
جودسميت	goudsmit
جودوينسون	godwinson
جوديث	judith
جوديريان	guderian
جوديير	goodyear
جورجا	jorja
جورجيتا	georgeta
جورجينا	georgina
جوردان	jordan
جوردانس	jordaens
جوردانو	giordano
جوردرين	jourdren
جوردون	gordon
جوردي	jordi
جوردين	jordin
جورسكي	gursky
جورفان	jorvan
جورليتز	gorlitz
جورني	gurney
جوروستيثا	gorostiza
جوري	gorey
جوزمان	guzman
جوزيفسن	josephson
جوزينكو	gouzenko
جوسبان	jospin
جوستاف	gustav
جوسنولد	gosnold
جوسيليتو	joselito
جوسيني	goscinny
جوش	josh
جوشوا	joshua
جوغبير	goegebuer
جوفان	goffin
جوفر	jover
جوفنيل	jouvenel
جوك	jock
جوكانوفتش	đokanovic
جول	jules
جولارت	goulart
جولتين	gulten
جولد	gould
جولدا	golda
جولدبلت	goldblatt
جولدسميث	goldsmith
جولدفارب	goldfarb
جولدمان	goldman
جولدوني	goldoni
جولدي	goldi
جولر	guler
جولى	joely
جولي	julie
جوليا	julia
جوليانا	juliana
جوميه	jomei
جون	john
جونا	jonah
جوناتان	jonatan
جونبوري	jaunpuri
جونز	jones
جونسون	johnson
جونغجو	jeongjo
جونغهي	jeonghui
جونكر	junger
جونكو	junko
جونكويت	jonquet
جونكيرمان	junkermann
جونمين	junmin
جونيا	junya
جونيتشي	junichi
جونينت	junyent
جونيوس	junius
جونیجو	junejo
جوهانسون	johannsson
جويرية	juwayriyya
جويس	joyce
جويل	joel
جويلهيرمي	guilherme
جوينتولي	guintoli
جوينر	joyner
جوينيزلي	guinizelli
جياجينغ	jiajing
جيافارمان	jayavarman
جياكوميتي	giacometti
جياكوميللي	giacomelli
جياكوميني	giacomini
جياماتي	giamatti
جيامباولو	giampaolo
جيانا	gianna
جيانسانتي	giansanti
جيانفرانكو	gianfranco
جيانكينغ	jianqing
جيانماريا	gianmaria
جياني	gianni
جيانيتى	gianetti
جيانيلو	gianello
جياي	jiayi
جيب	jeb
جيبسن	jepsen
جيبكواني	chepkwony
جيبون	gibbon
جيتا	gaeta
جيتشي	jiechi
جيتو	jito
جيجكا	zizka
جيجنديت	gigandet
جيد	jade
جيدس	geddes
جيدن	jaden
جيراردو	gerardo
جيراسيموف	gerasimov
جيرالد	gerald
جيرالدو	giraldo
جيرالدين	geraldine
جيرد	gerd
جيرفيس	jervis
جيرلاش	gerlache
جيرمانو	germano
جيرمي	jeremy
جيرمين	germaine
جيروم	jerome
جيري	jerry
جيريبكو	jerebko
جيرين	jerren
جيرينوفسكي	zhirinovsky
جيزر	geezer
جيزي	jeezy
جيزينغا	gizenga
جيس	jess
جيسن	jason
جيسنبير	giessenbier
جيسوس	jesus
جيسي	jesse
جيسيكا	jessica
جيسيل	jessel
جيسين	jessen
جيغلا	djigla
جيغمي	jigme
جيف	jeff
جيفارا	guevara
جيفرسون	jefferson
جيفوتشو	jeftichew
جيفونز	jevons
جيك	jake
جيلاردينو	gilardino
جيلبرتو	gilberto
جيلدوف	geldof
جيلر	geller
جيلري	gillray
جيلس	gilles
جيلكريست	gilchrist
جيلمين	gelmin
جيلنهال	gyllenhaal
جيليان	gillian
جيم	jim
جيما	gemma
جيماه	gyimah
جيمس	james
جيمسير	gemser
جيملستوب	gimelstob
جيموندي	gimondi
جيمي	jimmy
جينا	jenna
جينتاو	jintao
جينتشامب	jeunechamp
جينتنر	gentner
جينتون	genton
جينتير	ginter
جينثر	ginther
جيندراك	jindrak
جينر	jenner
جينغرون	jingrun
جينغو	jingu
جينغيني	genghini
جينكنسون	jenkinson
جينكينز	jenkins
جينمو	jimmu
جينوبيلي	ginobili
جيني	jenni
جيني	jenny
جينيس	gynes
جينيك	jenneke
جينينغز	jennings
جينيو	jinyu
جيهانكير	cihangir
جيهاي	jihai
جيوانا	geoana
جيوتي	jyoti
جيوفانيلي	giovanelli
جيوفري	geoffrey
جيول	jewel
حابس	habis
حاتم	hatem
حاتمي	hatami
حاجم	hajim
حارس	haris
حاروش	haroche
حازم	hazem
حاشد	hashid
حاطوم	hatoum
حامد	hamed
حاوي	hawi
حايك	hayek
حاييم	haim
حباب	habab
حبال	habbal
حبان	hibban
حبشى	habachi
حبيب	habib
حبيل	hubail
حبيلس	benhabyles
حتاتة	hatata
حجاب	hijab
حجاج	hajjaj
حجاوي	hadjaoui
حجيج	hojeij
حداد	haddad
حدادي	haddadi
حدراف	hadraf
حديد	hadid
حرب	harb
حردان	hardan
حرس	hetepheres
حرشاش	harcheche
حرفوش	harfouch
حركات	harkat
حركوك	harkouk
حزام	hizam
حزان	chazan
حزبون	hazboun
حزم	hazm
حسابي	hessaby
حسام	hossam
حسقيل	eskell
حسن	hassan
حسنين	hassanein
حسيبة	hassiba
حسين	hussein
حسيني	hosseini
حشلاف	hachlaf
حشيشة	hachicha
حصار	hassar
حصاري	karahisari
حصرية	husrieh
حصني	husni
حصين	husain
حطاب	hattab
حفاظ	haffadh
حفتر	haftar
حفص	hafs
حفصة	hafsa
حفصون	hafsun
حفني	hefny
حكمت	hikmat
حلاق	alak
حلاوة	halaweh
حلمى	helmy
حلو	helou
حليش‎	halliche
حماد	hammad
حمادي	hammadi
حماقي	hamaki
حمام	hmam
حمامو	hamamou
حمة	hamma
حمدان	hamdan
حمدي	hamdi
حمديس	hamdis
حمروش	hamrouche
حمري	hamri
حمزاوي	hamzawy
حمزة	hamza
حمنة	hammanah
حموش	hammouche
حمومة	hamouma
حمية	hamieh
حميضة	humaydah
حمينة	hamina
حنا	hanna
حنان	hanan
حناني	hanani
حنانيا	hanania
حنبل	hanbal
حنجور	hanjour
حننا	hanenna
حنيف	hunaif
حنين	hunayn
حواتمة	hawatmeh
حوراني	hourani
حوفي	hofi
حوقل	hawqal
حوى	hawwa
حياتو	hayatou
حيدر	haidar
حيزي	hezi
حيسو	hissou
حيوة	haywah
حيوي	hiwi
خارا	jara
خاشقجي	khashoggi
خاقان	khaqan
خالدي	khalidi
خالويه	khalawayh
خامنئي	khamenei
خان	khan
خانو	khano
خانيس	janes
خاير	hayır
خايمي	jaime
خاينادا	jaenada
خدابناهي	khodapanahi
خدام	khaddam
خديج	hudayj
خديجة	khadija
خرازي	kharazi
خرداذبة	khordadbeh
خرشاتوف	kurchatov
خروتشوف	khrushchev
خرونتشيف	khrunichev
خريس	khreis
خريمونبريز	grimmonprez
خزام	khuzam
خزري	khazri
خسرواني	pourkhosravani
خضراء	benkhadra
خضرة	khadra
خضري	khodari
خضيرة	khedira
خفاجة	khafaja
خفوستوف	khvostov
خلخالي	khalkhali
خلف	khalaf
خلفان	khalfan
خلكان	khallikan
خلوبونين	khloponin
خليفاوي	khleifawi
خليفة	khalifa
خليفمان	khalifman
خليفه	kalifa
خليلهودزيتش	halilhodzic
خليلي	khalili
خمرة	khumra
خميس	khamis
خميني	khomeini
خندق	chahkhandagh
خننيا	dinkha
خه	he
خواجو	khwaju
خوارزم	khwarezm
خوان	juan
خوخي	khoukhi
خودوركوفسكي	khodorkovsky
خورادو	jurado
خوري	khoury
خوزين	khozin
خوستو	justo
خولة	khawlah
خولماتوف	kholmatov
خوليت	gullit
خوموتوف	khomutov
خوناس	jonas
خويلد	khuwaylid
خيتروك	khitruk
خيرازي	kherrazi
خيرت	khairat
خيزنيتشينكو	khizhnichenko
خيسترز	heesters
خيسوس	jesus
خيسينتا	jesinta
خيضر	khider
خيفرين	jeffren
خيلمان	gelman
خيمينيز	jimenez
خينتو	gento
دا	da
دائي	daei
دابروفسكي	dabrowski
دابريلا	daprela
دابيول	dabul
داتولو	datolo
داتوم	datome
داتيه	date
داجوبيرت	dagobert
داجير	daguerre
داداريو	daddario
داداه	daddah
دادلي	dudley
داديس	dadis
دارا	dara
دارابونت	darabont
داراه	darragh
داربي	darby
دارتشفيل	darcheville
دارد	dard
دارداي	dardai
دارسيس	darcis
داركولم	darkholme
دارل	darrell
دارمشتات	darmstadt
دارون	darron
داروي	darui
دارويل	darwell
داروين	darwin
داريل	daryl
دارين	darren
داريوس	darius
دارييو	dario
دازاي	dazai
داستن	dustin
داسلر	dassler
داسوم	dasom
داغو	dago
داغوستينو	d'agostino
داغيغيلي	daghagheleh
دافاري	davari
دافو	dafoe
دافولوري	davuluri
دافي	duffy
دافيدوف	davydov
دافيدي	davide
دافيدينكو	davydenko
دافيرناس	dhavernas
دافيس	davies
دافيسون	davison
دافين	davin
دافينبورت	davenport
داكوستا	dacosta
دال	dahl
دالاس	dallas
دالاسين	dalassene
دالتري	daltrey
دالغليش	dalglish
داليا	dalia
داليان	dalian
داليبور	dalibor
داليساندرو	d'alessandro
داليما	d'alema
دالَّا	dalla
دام	dam
داماركوس	damarcus
داماسو	damaso
داماسيو	damasio
داماناكيس	damanakis
داماني	damani
دامبروزيو	d'ambrosio
دامبير	dampier
دامشك	dameshek
دامون	damon
دامي	dame
داميان	damien
داميانو	damiano
داميانوفيتش	damjanovic
دامياو	damiao
دان	dan
دانا	dana
دانتزغ	dantzig
دانتي	dante
داندولو	dandolo
دانر	danner
دانزي	danze
دانستابل	dunstaple
دانسون	danson
دانسي	dancy
دانغي	dangi
دانغيونغ	dangyeong
دانكمار	dankmar
دانكو	danko
دانو	dano
دانوت	danot
دانون	danon
داني	danny
دانية	dania
دانيك	danic
دانيلو	danilo
دانينوس	daninos
دانييلا	daniela
دانييلز	daniels
دانييلسن	danielsen
دانييلي	daniele
داهان	dahan
داهر	dahir
داو	tao
داوان	dawan
داوتشيك	daucik
داودا	daouda
داوس	daws
داوسون	dawson
داون	down
داوني	downey
داياك	dayak
دايتون	dayton
دايجيرو	daijiro
داير	dyer
دايرو	dayro
دايزنهوفر	deisenhofer
دايسكي	daisuke
دايسلر	deisler
دايف	dave
دايفيد	david
دايل	dale
دايلمان	deilmann
دايليدر	daileader
دايملر	daimler
داينيلي	dainelli
دايي	daye
دباس	debbas
دباغ	dabagh
دبريتيس	depretis
دبستر	depestre
دبلن	dublin
دبيس	debise
دتمر	dettmer
دجاكبا	djakpa
دجالو	djalo
دجانة	dujana
دجوركاييف	djorkaeff
دجورو	djourou
دجوغو	djeugoue
دجوكوفيتش	djokovic
دجيان	djian
دجيتي	djite
دجيسيكادي	djissikadie
دحلان	dahlan
دحيات	dahiyat
دخيل	dakheel
دراجس	dragas
دراغان	dragan
دراغنيا	dragnea
دراغوتينوفتش	dragutinovic
دراغوسلاف	dragoslav
دراغومير	dragomir
دراغيتش	dragic
دراق	derrag
دراكر	drucker
دراكسلر	draxler
درامان	dramane
درانبور	derenbourg
دراهايم	draheim
درايز	dries
درايزر	dreiser
درايس	drais
درايفوس	dreyfuss
درايموند	draymond
درة	durra
درجال	dirjal
درميك	drmic
درو	drew
دروبسي	dropsy
دروبني	drobny
دروجبا	drogba
درود	drude
دروري	drury
دروسير	derosier
دروسين	drossin
دروشل	druschel
دروغو	drogo
دروفليه	durufle
دروموند	drummond
درويان	druyan
درويش	darwish
دريد	duraid
دريدا	derrida
دريزن	droysen
دريشر	drescher
دريفوس	dreyfus
دريكامر	drickamer
دريم	dream
دريما	dreama
دريمر	dreamer
درينغوت	drengot
درينفيلد	drinfeld
دريوري	drewry
دزاغويف	dzagoev
دزرائيلي	disraeli
دزوغاشفيلي	dzhugashvili
دزيرجينسكي	dzerzhinsky
دزيمليف	dzhemilev
دشني	dashni
دشوفني	duchovny
دعيس	adais
دغتيريوف	degtyaryov
دفاليشفيلي	dvalishvili
دفيكا	devika
دقنة	digna
دل	del
دلا	della
دلادييه	daladier
دلاكاما	dhlakama
دلبروك	delbruck
دلبي	delpy
دلبيش	delpech
دلفينو	delfino
دلهوم	delhoum
دليب	dilip
دليطة	dileita
دليلة	dalila
دليمخانوف	delimkhanov
دليوس	delius
دمان	demunn
دميتري	dmitry
دميترييف	dmitriyev
دن	den
دنتون	denton
دنجلر	dengler
دنفر	denver
دنكان	duncan
دنكطاش	denktas
دنكليج	dinklage
دنهولم	denholm
دنيا	donia
دنيز	deniz
دنيزلي	denizli
دنيس	dennis
دهخدا	dehkhoda
دهود	dahoud
دهيريل	d'herelle
دهينة	dhina
دوارتي	duarte
دوالده	duhalde
دوايت	dwight
دواين	dwayne
دوباربيير	dubarbier
دوباي	dobay
دوبتشيك	dubcek
دوبراف	dobrev
دوبروفولسكي	dobrovolski
دوبري	duberry
دوبرينير	dobereiner
دوبلاس	doblas
دوبلر	doppler
دوبلن	doblin
دوبلوس	duplus
دوبوي	dupuy
دوبيا	dhupia
دوبياس	dobias
دوت	dutt
دوتري	daughtry
دوتشكه	dutschke
دوتل	dhotel
دوتو	dotto
دوتون	dutton
دوتويل	dutuel
دوتيش	deutsch
دوجان	dugain
دوجراي	dougray
دوداش	dudas
دودو	dudu
دوديج	dodig
دوديل	dowdell
دودين	dudin
دوديه	daudet
دورادو	dorado
دورانتي	durante
دوراند	durand
دورجليه	dorgeles
دورجي	dorji
دوردا	dorda
دوردان	dourdan
دورسن	dorsin
دورسون	dursun
دورسي	dorsey
دوركايم	durkheim
دورمر	dormer
دورنان	dornan
دورنبوس	doornbos
دورنيكامب	doornekamp
دوروثي	dorothy
دورينمات	durrenmatt
دوز	dawes
دوس	dos
دوسامانتس	dosamantes
دوساي	ducey
دوستم	dostum
دوسينا	dossena
دوسينبيرغ	duisenberg
دوشامب	duchamp
دوشان	dusan
دوشيز	douchez
دوغاري	dugarry
دوغان	dogan
دوغرا	dogra
دوغلاس	douglas
دوغلو	dogulu
دوفال	duvall
دوفالييه	duvalier
دوفان	duvan
دوفجنكو	dovzhenko
دوفرات	dovrat
دوفور	dufaure
دوكا	dukas
دوكاتيل	ducatel
دوكري	dockery
دوكريه	ducret
دوكس	dockx
دوكليا	duklja
دوكهي	deokhye
دوكوتشاييف	dokuchaev
دوكيانوس	dokeianos
دوكيرتي	docherty
دوكينز	dawkins
دولان	dolan
دولاين	dulaine
دولبي	dolby
دولبيكو	dulbecco
دولت	devlet
دولت‌آبادی	dowlatabadi
دولسي	dulce
دولغوروكي	dolgorukiy
دوللي	dolley
دولماتوف	dolmatov
دولمان	doellman
دولوز	deleuze
دولوفيو	deulofeu
دولي	dooley
دوماس	dumas
دوماغوي	domagoj
دومبيا	doumbia
دومة	douma
دومرغ	doumergue
دومشايت	domscheit
دومنا	domna
دومنغيني	domenghini
دومنك	doumenc
دومورو	domoraud
دوموفتشيسكي	domovchiyski
دومولين	dumoulin
دوميت	dummett
دوميتراكي	dumitrache
دومير	doumer
دوميرغ	domergue
دومينغو	domingo
دومينيغوس	domingos
دومينيك	dominique
دومينيكو	domenico
دون	don
دونا	donna
دوناتي	donati
دوناديل	donadel
دوناوي	dunaway
دوناي	dunai
دوندر	donder
دونر	donner
دونسكوي	donskoy
دونسو	donoso
دونغ	dong
دونلسون	donelson
دونليفي	dunleavy
دونوهيو	donohue
دونيزيتي	donizetti
دونيلا	donella
دوهاميل	duhamel
دوهان	doohan
دوهرتي	doherty
دووموه	dwomoh
دوي	doi
دويت	dawit
دويدار	duiedar
دويل	doyle
دى	de
دى	de
ديا	dia
دياب	diab
دياباتي	diabate
ديابي	diaby
ديارا	diarra
دياز	diaz
دياس	dias
دياكاتي	diakhate
دياكونو	diaconu
دياكيتي	diakite
ديالبيرت	dealbert
ديامانتوبولوس	diamantopoulos
ديامانتي	diamanti
ديامانتينو	diamantino
ديامي	diame
ديان	diane
ديانا	diana
دياو	diao
دياوارا	diawara
ديب	deeb
ديبا	diba
ديبارديو	depardieu
ديباش	debbasch
ديبالا	dybala
ديباني	debbana
ديباي	debye
ديبرو	debreu
ديبروسي	debrosse
ديبريه	debray
ديبلاس	deplace
ديبوسي	debussy
ديبي	debbie
ديبياسي	dibiase
ديبيكي	debicki
ديبينبيك	diepenbeek
ديتانا	ditana
ديتبيرنر	dittberner
ديترون	dutronc
ديتريكس	diterikhs
ديتز	dietz
ديتزين	dietzen
ديتمار	dietmar
ديتمرز	detmers
ديتوري	dettori
ديتياتين	dityatin
ديجلر	degler
ديدافي	didavi
ديدكايند	dedekind
ديدوش	didouche
دير	der
ديراك	dirac
ديربورن	dearborn
ديرديك	dyrdek
ديرك	dirk
ديركين	diercken
ديرموت	dermot
ديرن	dern
ديرنيس	dernis
ديرون	deron
ديريباسكا	deripaska
ديريك	derek
ديرين	deren
ديزا	deza
ديزل	diesel
ديزمن	desman
ديزموند	desmond
ديزني	disney
ديزي	daisy
ديزيري	desire
ديسا	dissa
ديسالفو	disalvo
ديسبويلونز	desbouillons
ديسبينا	despina
ديسترو	destro
ديستروميلي	destrumelle
ديسميوك	dismuke
ديسينا	dessena
ديشامب	deschamps
ديشانيل	deschanel
ديشين	dexin
ديغا	degas
ديغارد	digard
ديغبي	digby
ديفايلدر	devilder
ديفرينت	devrient
ديفلاندر	deflandre
ديفلين	devlin
ديفن	devine
ديفوار	devouard
ديفور	defour
ديفوس	devos
ديفوسي	defosse
ديفوف	divoff
ديفون	devon
ديفيتو	devito
ديفيدز	davids
ديفيدسن	davidson
ديفيدمان	davidman
ديفيس	davis
ديفيسا	devesa
ديفينسينزي	devincenzi
ديك	dick
ديكامب	descamps
ديكر	decker
ديكرانوس	tigranes
ديكرسون	dickerson
ديكستر	dexter
ديكميير	diekmeier
ديكنز	dickens
ديكود	decoud
ديكوف	dickov
ديكون	deacon
ديلا	della
ديلاب	delap
ديلارد	dillard
ديلافيدوفا	dellavedova
ديلافيوري	dellafiore
ديلامبر	delambre
ديلان	dylan
ديلايل	delisle
ديلبورت	delporte
ديلبيكي	delbeke
ديلر	diller
ديلز	diels
ديلسون	delson
ديلغادو	delgado
ديلف	delph
ديلفور	delfour
ديلفيم	delfim
ديلم	dilem
ديلموتي	delmotte
ديلنيري	delneri
ديلو	dilou
ديلوكا	deluca
ديلون	dillon
ديلوناي	delaunay
ديليبيس	delibes
ديليفين	delevingne
ديلين	deligne
ديليو	delio
ديم	demme
ديماجيو	dimaggio
ديمارتينو	dimartino
ديمارس	demarest
ديمازور	demazure
ديمايو	demayo
ديمبا	demba
ديمبسي	dempsey
ديمة	dima
ديموت	demuth
ديمور	d'amore
ديموند	demond
ديمي	demy
ديميانينكو	demyanenko
ديميتار	dimitar
ديميتري	dimitri
ديميتريو	demetrio
ديميتريوس	demetrius
ديميراغ	demirag
ديميريت	demerit
ديميريل	demirel
دينا	dina
دينارا	dinara
دينام	denham
دينت	dent
دينتري	daintree
ديندال	dindal
دينر	denner
دينغ	deng
دينك	denke
دينو	dino
دينيت	dennett
دينيز	diniz
دينيكين	denikin
دينيلسون	denilson
دينيهي	dennehy
ديهن	dehn
ديوار	dewar
ديوت	diot
ديوجانس	diogenes
ديودورو	deodoro
ديودوروس	diodorus
ديور	dior
ديورانت	durant
ديوز	dieuze
ديوس	deus
ديوغو	diogo
ديول	deol
ديون	dion
ديوه	dioh
ديوي	dewey
ديويل	deuel
دييغو	diego
دیمي	demi
ذهيبة	dehiba
رءوف	raouf
رئيل	riel
راؤل	raoul
رائف	raif
راب	rapp
راباسيدا	rabaseda
رابان	rabanne
راباييتش	rapaic
رابليه	rabelais
رابه	raabe
رابوبورت	rapoport
رابويل	rabuel
رابين	rabin
رابينوفيتش	rabinovich
رابيو	rabiu
رابييف	rabiev
رات	rat
راتزل	ratzel
راج	raj
راجابو	radjabu
راجح	rageh
راجسكوب	rajskub
راجي	raggi
راجيف	rajiv
راجيندرا	rajendra
راخات	rakhat
راخوي	rajoy
رادانوفيتش	radanovic
رادت	raadt
رادزينسكي	radzinski
رادستون	rudston
رادنر	radnor
رادوسلاف	radoslav
رادولف	rudolph
رادوليسكو	radulescu
رادومير	radomir
راديا	radia
راديجيه	radiguet
راديسكو	radescu
راديشي	radice
راديك	radek
راديلكيس	radelchis
راذير	rather
رازناتوفيتش	raznatovic
راس	raas
راسبوتين	rasputin
راست	rust
راستشك	raschke
راسك	rusk
راسموسن	rasmussen
راسنييه	rassinier
راسيل	russell
راسين	racine
راشد	rashid
راشدي	rachedi
راشيم	rasheim
راضي	radhi
راضیة	raziye
راغ	rugg
راغولين	ragulin
راف	ruff
رافال	rafał
رافان	rafan
رافانيلي	ravanelli
رافاييل	rafael
رافتل	raftl
رافي	ravi
رافير	ravier
رافيرتي	rafferty
رافينسك	rafinesque
رافينسكي	raffinsky
رافينيت	ravinet
راقم	rakim
راك	ruck
راكا	racca
راكهام	rackham
راكوتوندرامانانا	rakotondramanana
راكوسي	rakosi
راكيتسكي	rakitskiy
راكيتيتش	rakitic
رالديس	raldes
رالستون	ralston
رالي	raleigh
رام	ram
راما	rama
راماج	ramage
راماري	ramare
رامازوتي	ramazzotti
رامبال	rampal
رامبالدي	rambaldi
رامبلينج	rampling
رامبو	rimbaud
رامبور	rambures
رامبوني	rampone
رامبيرت	rambert
رامز	ramez
رامزي	ramsay
رامسفيلد	rumsfeld
رامسي	ramsey
راموس	ramos
رامون	ramon
رامي	rami
راميرو	ramiro
راميريز	ramirez
راميز	mariz
راميس	ramis
رامين	ramin
رانافالونا	ranavalona
رانبير	ranbir
راندال	randall
راندون	randon
راندي	randy
رانسفورد	ransford
رانغام	wrangham
رانغل	rangel
رانغيلوف	rangelov
رانفير	ranveer
رانفييه	ranvier
رانك	rank
رانكه	ranke
رانوكيا	ranocchia
راني	rani
راهول	rahul
راوخ	rauch
راولاندسون	rowlandson
راولزينهو	raulzinho
راي	ray
رايت	wright
رايتش	reitsch
رايتشل	rachael
رايتشل	rachel
رايتمان	reitman
رايخشتاين	reichstein
رايخيناو	reichenau
رايدبيرغ	rydberg
رايدر	ryder
رايز	rhys
رايزيغير	reiziger
رايش	reich
رايشاوير	reischauer
رايكوفيتش	rajkovic
رايلي	riley
رايموند	raymond
رايمي	raimi
راينا	rainea
راينبو	rainbow
راينتكه	reintke
رايندرز	reynders
راينر	rainer
راينس	reines
راينيش	reinisch
رباح	rabah
رباعين	rebaine
ربلي	ripley
ربيعه	rabea
ربيكا	rebeca
رجب	rajab
رجب‌	rajabzadeh
رجوي	rajavi
رجي	rajji
رجيبة	rejiba
رحاب	rihab
رحال	rahal
رحماني	rahmani
رحيم	rahim
رحيمه	rehema
رخمانينوف	rachmaninoff
ردن	raden
رذرفورد	rutherford
رزاق	razak
رزان	razan
رزق	rizk
رسن	rasan
رسول	rasul
رسولي	rasouli
رشيدة	rashida
رضوى	radwa
رعد	raad
رغد	raghad
رفعت	rifaat
رفقي	refki
رفلة	rafla
رفيق	rafik
رفيقة	rafika
ركلينغهاوزن	recklinghausen
ركوردز	records
رمثة	ramtha
رمزية	ramziya
رمسيس	ramesses
رمنجساو	remengesau
رمونا	ramona
رن	wren
رنا	rana
رندة	randa
رندل	randle
رنستروم	runstrom
رنشلر	renschler
رنفال	renvall
روار	rouart
روالد	roald
روانو	ruano
روب	rob
روبالكابا	rubalcaba
روبرت	robert
روبرتا	roberta
روبرتس	roberts
روبرتسون	robertson
روبرتو	roberto
روبريدو	robredo
روبك	robic
روبليوف	rublev
روبن	robin
روبنس	rubens
روبنسون	robinson
روبنشتاين	rubinstein
روبوتشي	robuschi
روبي	robbie
روبينز	robbins
روبيو	rubio
روت	ruth
روتا	rota
روتارو	rotaru
روتان	rutan
روتبلت	rotblat
روتر	rutter
روتش	roach
روتشا	rocha
روتشز	rochez
روتشيلد	rothschild
روتشيمباك	rochemback
روتشينا	rochina
روتل	ruutel
روتلديج	routledge
روته	rutte
روتين	rotten
روتينسولو	rotinsulu
روثبورد	rothbard
روثلسبيرغر	rothlisberger
روثمان	rothman
روجديستفنسكي	rozhdestvensky
روجر	roger
روجرس	rogers
روجوفسكا	rogowska
روجينكو	rodchenko
روحانا	rouhana
رودات	rodat
رودانج	rodange
رودبل	rodbell
رودريجوز	rodriguez
رودريغو	rodrigo
رودريغيث	rodriguez
رودس	rhodes
رودمان	rodman
رودنسون	rodinson
رودني	rodney
روده	rode
رودولف	rudolf
رودولفو	rodolfo
رودولفي	rodolphe
رودويل	rodwell
رودي	rudy
روديت	roudet
روديجر	rudiger
روديك	roddick
روديونوف	rodionov
روراوة	raouraoua
رورتي	rorty
روزا	rosa
روزاتو	rosato
روزالي	rosalie
روزاليس	rosales
روزاليند	rosalind
روزاموند	rosamund
روزانا	rosanna
روزفلت	roosevelt
روزنبرغ	rosenberg
روزنفيلد	rosenfeld
روزيتا	rosita
روزيل	rozelle
روس	ross
روساريو	rosario
روسبيرغ	rosberg
روستان	rostand
روستاني	rostagni
روستيشيلو	rustichello
روسدي	rosdi
روسديسكي	rusedski
روسلينج	rosling
روسنكرانز	rosenkranz
روسنهن	rosenhan
روسي	rossi
روسيا	russia
روسيتو	rosseto
روسيتيني	rossettini
روسيلي	roseli
روسيليني	rossellini
روسينيور	rosenior
روسيه	rosset
روش	rush
روشيتو	rocheteau
روشيل	rochelle
روشينق	rushing
روغر	prager
روغن	rogen
روغه	ruge
روغوزين	rogozin
روغيفين	roggeveen
روفا	redfa
روفو	ruffo
روفيري	rovere
روفيني	ruffini
روفيير	ruffier
روك	rock
روكاستلي	rocastle
روكاش	rokach
روكافينا	rukavina
روكان	rokkan
روكر	rooker
روكس	rooks
روكساس	roxas
روكفلر	rockefeller
روكهيل	rockhill
روكوس	rochus
روكويل	rockwell
رولا	rola
رولاند	roland
رولاندو	rolando
رولدر	roleder
رولس	rawls
رولستون	rolston
رولف	rolf
رولنسون	rawlinson
رولي	rulli
رولينج	rowling
رولينز	rollins
روم	rohm
روماريو	romario
روماشينا	romashina
رومان	roman
رومانتسيف	romantsev
رومانز	romanes
رومانوس	romanos
رومانيا	romania
رومر	roemer
رومل	rommel
رومني	romney
رومو	romo
روموالدو	romualdo
رومور	rumor
رومولو	romulo
روميت	romit
روميدال	rommedahl
روميرو	romero
رومين	romain
رومينغر	rominger
رونالد	ronald
رونالدسون	ronaldson
رونتشتيت	rundstedt
رونتغن	rontgen
رونجه	runge
روندز	rounds
روندون	rondon
رونديه	renaudie
رونسار	ronsard
رونسون	ronson
رونغ	rong
رونكاجليولو	roncagliolo
رونكاليا	roncaglia
روني	ronnie
روهان	rohan
روهيت	rohit
رووامبا	rouamba
رووتسالاينن	ruotsalainen
روون	rowen
روي	roy
رويال	royall
رويتمان	roitman
رويثك	roethke
رويدر	roeder
رويغ	roeg
ريارد	reard
رياشي	riachi
ريال	rial
ريام	ream
ريان	ryan
ريب	rep
ريبا	ripa
ريباس	ribas
ريباك	rybak
ريباكوف	rybakov
ريباكوفا	rypakova
ريبالكو	rybalko
ريبريك	rebrik
ريبكين،	ripken
ريبلين	rebellin
ريبنتروب	ribbentrop
ريبولوفليف	rybolovlev
ريبوليس	ripolles
ريبي	rippy
ريبيرو	ribeiro
ريبيسي	ribisi
ريبيكا	rebecca
ريتا	rita
ريتر	ritter
ريتزولي	rizzoli
ريتسوس	ritsos
ريتشارد	richard
ريتشاردز	richards
ريتشاردسون	richardson
ريتشه	reiche
ريتشو	richu
ريتشي	ritchie
ريتشيوتي	ricchiuti
ريتون	retton
ريج	reg
ريجان	regan
ريجانو	rigano
ريجنالد	reginald
ريجيس	regis
ريخا	reija
ريخنباخ	reichenbach
ريدال	riddell
ريدجواي	ridgway
ريدغريف	redgrave
ريدفورد	redford
ريدلي	ridley
ريدمان	redman
ريدماين	redmayne
ريدهاوس	redhouse
ريدون	redon
ريديك	redick
ريدينغ	redding
ريزال	rizal
ريزيك	rezek
ريزينغر	reisinger
ريسا	risa
ريسبوروج	riseborough
ريسبيرغن	rijsbergen
ريستريبو	restrepo
ريسر	risser
ريسونر	reasoner
ريشة	risha
ريشتر	richter
ريشفسكى	reshevsky
ريشنجر	rechinger
ريشه	richet
ريغا	riga
ريغل	riegel
ريغوبرت	rigobert
ريغوت	riggott
ريغوني	rigoni
ريغيل	regel
ريغين	reigen
ريغيورا	reguera
ريغييرو	regueiro
ريفا	riva
ريفاس	rivas
ريفر	raver
ريفرز	rivers
ريفرزي	reverzy
ريفست	rivest
ريفسون	revson
ريفولورو	revolori
ريفير	revere
ريفيرا	rivera
ريفيرو	rivero
ريفيلير	reveillere
ريفيليون	reveillon
ريفينيت	rivenet
ريك	rick
ريكا	rica
ريكارد	rijkaard
ريكاردي	regardie
ريكمان	rickman
ريكوبا	recoba
ريكور	ricœur
ريكي	ricky
ريكيا	rikiya
ريكيتس	ricketts
ريكيلمي	riquelme
ريكيو	rikyu
ريلكه	rilke
ريم	reem
ريما	rima
ريمار	remar
ريمارو	rimaru
ريمر	remer
ريمز	reems
ريميتير	remetter
ريمير	rymer
ريميك	remick
ريميه	rimet
ريناتو	renato
رينار	renard
رينان	renan
رينجر	ringer
رينجيفو	rengifo
ريندت	rindt
ريندوليتش	rendulic
رينز	reigns
رينزو	renzo
رينزي	renzi
رينسنج	rensing
رينسيلار	rensselaer
رينسين	rensen
رينفرو	renfroe
رينكو	rinko
رينكوين	renquin
رينهارت	rinehart
رينوار	renoir
رينوتر	rainwater
رينودو	rinaudo
رينولدز	reynolds
رينولف	rainulf
رينيدي	renedy
رينيه	rene
ريه	rie
ريهاجل	rehhagel
ريوبن	reuben
ريوتا	ryota
ريوتارو	ryutaro
ريوتش	rioch
ريوتيمان	reutemann
ريوجي	ryuji
ريوريكوفيتش	rurikovich
ريوس	rios
ريوكو	ryoko
ريوكيل	rockel
ريولفو	riolfo
ريوما	ryoma
ريوهي	ryohei
ريوهيه	ryouhei
رييبروك	reybrouck
رييرا	riera
رييزي	reizei
رييس	reyes
زاب	zapp
زابا	zappa
زاباتير	zapater
زابافنيك	zabavnik
زاباليتا	zabaleta
زابو	szabo
زابيكو	zapico
زابيير	xabier
زات	zat
زاتوبك	zatopek
زاخاروف	zakharov
زارا	zara
زاراتي	zarate
زارغو	zargo
زاركو	zarko
زاري	zare
زاريلا	zarrella
زارين	zarine
زازا	zaza
زاكارياس	zacharias
زاكاريلي	zaccarelli
زاكازاكا	zakazaka
زاكاني	zakani
زاكر	zucker
زاكمان	sakmann
زاكواني	zakuani
زاكيرولي	zacchiroli
زالاي	szalay
زالايتا	zalayeta
زاليوتين	zalyotin
زاليوكاس	zaliukas
زامبرانو	zambrano
زامبروتا	zambrotta
زامبو	zambo
زامبوري	zampori
زامبيلي	zambelli
زامر	sammer
زامورا	zamora
زامورانو	zamorano
زامير	zamir
زانا	zana
زانت	zant
زانتيك	zanetic
زانج	zhang
زانغويل	zangwill
زانيتي	zanetti
زانيني	zanini
زاهوفيتش	zahovic
زاوبر	zauber
زاورلاند	sauerland
زاي	zai
زايتسيف	zaytsev
زايد	zayed
زايزندورف	zinzendorf
زبابا	zababa
زبانة	zabana
زبرماوي	zubromawi
زبلين	zeppelin
زبير	zoubeir
زتكن	zetkin
زحالقة	zahalka
زخنيني	zekhnini
زدورفيسكي	zdorovetskiy
زديبيل	zdebel
زدينيك	zdenek
زرارة	zurarah
زرداري	zardari
زرع	zar
زرعة	zur’a
زرهوني	zerhouni
زعزوع	zazou
زعفراني	zafarani
زعير	zair
زغلول	zaghloul
زغونيا	zgonea
زغيب	zgheib
زفامردام	swammerdam
زفان	zeffane
زفزاف	zafzaf
زفوناريفا	zvonareva
زفيكي	zwicky
زكريا	zakaria
زكزكي	zakzaky
زكي	zaki
زكية	zakya
زكير	zakir
زلاتان	zlatan
زلزلي	zalzali
زليخة	zuleyka
زماني	zamani
زمع	zema
زميري	zimri
زنجاني	zanjani
زندكاني	zendegani
زنكنة	zangana
زنيبر	zniber
زها	zaha
زهتنر	zehetner
زهران	zahran
زهري	zuhri
زهيرة	zouheira
زهيو	zhiou
زوبربوهلر	zuberbuhler
زوبيزاريتا	zubizarreta
زوتميلك	zoetemelk
زوتنبرغ	zotenberg
زوران	zoran
زورو	zoro
زوروتوزا	zurutuza
زوسكيند	suskind
زوسموت	sussmuth
زوغانوف	zyuganov
زوكاريني	zuccarini
زوكربيرغ	zuckerberg
زوكرمان	zuckerman
زوكري	czuchry
زوكورا	zokora
زوكوليني	zuculini
زولا	zola
زولتان	zoltan
زولد	szold
زوليك	zoellick
زومانا	zoumana
زومثور	zumthor
زوميلزو	zumelzu
زونارو	zonaro
زوندرفان	zondervan
زونغ	zong
زونغو	zongo
زوننشاين	sonnenschein
زونيغا	zuniga
زوي	zoe
زويريب	xuereb
زويمر	zwemer
زوينير	zwiener
زياد	ziad
زيالور	zialor
زياني	ziani
زيبالوس	zeballos
زيبولون	zebulon
زيبيدا	zepeda
زيبينا	zebina
زيتكا	zitka
زيتو	zito
زيتوت	zitout
زيتونة	zaitouneh
زيد	zayd
زيدون	zaydun
زيديلو	zedillo
زيرك	zirak
زيرنج	ziering
زيري	ziri
زيريانوف	zyryanov
زيزتا	sesta
زيزي	zizi
زيغرس	zegers
زيغلر	ziegler
زيغمار	sigmar
زيلايا	zelaya
زيلكا	zylka
زيلين	zelin
زيلينسكي	zielinski
زيلينشكي	zielinski
زيمان	zeman
زيمباردو	zimbardo
زيمر	zimmer
زيمرمان	zimmermann
زيملينغ	zimling
زيمور	zemor
زيمونيتش	zimonjic
زيمياتوف	zimyatov
زيميك	zemke
زيميكس	zemeckis
زيمين	zemin
زينشتروم	zennstrom
زينغا	zenga
زينكو	zenko
زينون	zeno
زينوني	zenoni
زينيوف	zenjov
زيهوفر	seehofer
زيور	ziwar
زيي	ziyi
سآري	saari
سا	sa
سابا	saba
سابات	sabat
ساباتو	sabato
ساباتير	sabater
ساباتينا	sabatina
ساباتيني	sabatini
ساباتييه	sabatier
سابان	saban
ساباو	sabau
سابرينا	sabrina
سابلي	sable
سابوريو	saborio
سابيلون	sabillon
سابيليوليوما	suppiluliuma
ساتروستيغي	satrustegui
ساتشا	sascha
ساتو	sato
ساتورو	satoru
ساتومي	satomi
ساتيا	sathya
ساتير	satir
سادلر	sadler
سادوفي	sadovyi
سار	sarr
سارا	sara
سارابيا	sarabia
ساراماغو	saramago
ساربي	sarpei
سارة	sarah
سارتر	sartre
سارجان	sargun
سارجنت	sargent
ساردو	sardo
سارسجارد	sarsgaard
ساركوزي	sarkozy
سارلى	sarli
سارمينتو	sarmiento
سارندون	sarandon
ساروتي	sarraute
ساروج	saroj
ساروسي	sarosi
سارون	sarron
ساروني	saronni
سارويان	saroyan
سازونافا	sazonova
ساساكي	sasaki
ساساموتو	sasamoto
ساستري	sastre
ساسو	sasso
ساسوس	sassus
ساسون	sasson
ساشا	sasha
ساشي	sahay
ساشيكو	sachiko
ساغانوفسكي	saganowski
ساغبو	sagbo
ساف	sobekemsaf
سافاري	savary
سافولديلي	savoldelli
سافون	savon
سافوي	savoy
سافيانو	saviano
سافيج	savage
سافيل	saville
سافيمبي	savimbi
سافين	safin
سافيو	savio
سافيولا	saviola
ساكاغتشي	sakaguchi
ساكاموتو	sakamoto
ساكاي	sakai
ساكر	sacre
ساكس	saxe
ساكستون	saxton
ساكسون	saxon
ساكسونيا	saxony
ساكو	sako
ساكوراماتشي	sakuramachi
ساكوراي	sakurai
ساكون	sakon
ساكوواها	sakuwaha
ساكي	saki
ساكيشي	sakichi
ساكيموتو	sakimoto
سالا	sala
سالابو	salapu
سالاس	salas
سالاشي	szalasi
سالافيا	salafia
سالاك	salak
سالاندرا	salandra
سالتمان	saltman
سالدانا	saldana
سالز	salz
سالزمان	salzman
سالستون	sulston
سالسيدو	salcedo
سالغادو	salgado
سالفاتوري	salvatore
سالفادور	salvador
سالفياتي	salviati
سالفيني	salvini
سالفيو	salvio
سالم	salem
سالمون	salmon
سالمين	salmeen
سالو	salo
سالوم	salom
سالومون	salomon
سالي	sally
ساليجاري	saligari
ساليرنو	salerno
ساليش	salesh
ساليف	salif
سالين	sahlin
ساليناس	salinas
سالينكو	salenko
سالييري	salieri
سام	sam
سامارتينو	sammartino
ساماركو	sammarco
ساماريس	samaris
سامال	samal
سامانثا	samantha
سامباولي	sampaoli
سامبايو	sampaio
سامبر	samper
سامبراس	sampras
سامبور	sambourne
سامبورا	sambora
سامبيدرو	sampedro
سامبيرج	samberg
سامبيغو	sambegou
سامر	samer
سامسونوف	samsonov
ساموديو	samudio
ساموند	salmond
سامونز	sammons
سامويلسون	samuelson
سامي	sami
سامية	samia
ساميتيير	samitier
سامينا	samina
سان	san
سانا	sanna
سانابريا	sanabria
ساناتيسكو	sanatescu
سانادا	sanada
سانازارو	sannazaro
ساناي	sanae
سانتاريلي	santarelli
سانتاغوستينو	santagostino
سانتاماريا	santamaria
سانتامارينا	santamarina
سانتانا	santana
سانتاندير	santander
سانتانشي	santanche
سانتوخي	santokhi
سانتورم	santorum
سانتورو	santoro
سانتوس	santos
سانتوللا	santaolalla
سانتون	santon
سانتياغو	santiago
سانتيني	santini
سانجاي	sanjay
سانجر	sanger
سانخورخو	sanjurjo
ساند	sand
سانداو	sandow
ساندبيرغ	sandburg
ساندر	sander
ساندرس	sanders
ساندري	sandri
ساندريلي	sandrelli
ساندز	sands
ساندفورد	sandford
ساندور	sandor
ساندورفي	sandorfi
ساندول	sundell
ساندومييرسكي	sandomierski
ساندي	sandy
سانديغ	sandage
سانز	sanz
سانسوفينو	sansovino
سانسوم	sansom
سانسون	sanson
سانسونيتي	sansonetti
سانشا	sancha
سانشو	sancho
سانشيز	sanchez
سانغ	sang
سانكارا	sankara
سانوغو	sanogo
سانيول	sagnol
ساها	saha
ساوانو	sawano
ساواو	sawao
ساوثول	southall
ساودر	souder
ساوذي	southey
ساور	sauer
ساورا	saura
ساوري	saori
ساوكين	saucken
ساول	saul
ساوميل	saumel
ساويرس	sawiris
ساياكو	sayako
سايتز	seitz
سايدنر	sidner
سايرس	cyrus
سايشل	seychelle
سايغو	saigo
سايفيت	saivet
سايكو	saeko
سايكي	saeki
سايلور	saylor
ساينز	sainz
ساينفيلد	seinfeld
ساينكو	saenko
سباجياري	spaggiari
سبادارو	spadaro
سبادوليني	spadolini
سبادي	spady
سباركس	sparks
سبارل	sperl
سبارمان	sparrman
سباستيان	sebastian
سباسكي	spassky
سبال	spall
سباليتي	spalletti
سبانيك	spanic
سبحاني	subhani
سبرنجر	sprenger
سبري	spry
سبرينكل	sprinkle
سبع	saba'a
سبعان	abousaban
سبعاوي	sabawi
سبعين	sab'in
سبليتر	splitter
سبنس	spence
سبنسر	spencer
سبهان	sabhan
سبهري	sepehri
سبورجون	spurgeon
سبورلوك	spurlock
سبوك	spock
سبولسكي	spolsky
سبولي	spolli
سبوليتو	spoleto
سبونر	spooner
سبيتزر	spitzer
سبيتشر	spycher
سبيدر	spader
سبيرانسكي	speransky
سبيرانوفيتش	spiranovic
سبيرتوس	spertus
سبيرز	spears
سبيرمان	spearman
سبيرمون	spearmon
سبيروني	sperone
سبيسرد	spessard
سبيسي	spacey
سبيكة	sabika
سبيلا	sabila
سبيلبرغ	spielberg
سبيلنغ	spelling
سبيمان	spemann
سبينازولا	spinazzola
سبينوزا	spinoza
ستابليتون	stapleton
ستابيلي	stabile
ستاثام	statham
ستاد	gardestad
ستار	starr
ستارجس	sturgess
ستاركويزر	starkweather
ستافورد	stafford
ستافيليديس	stafylidis
ستاك	stack
ستال	stahl
ستالتيري	stalteri
ستالون	stallone
ستالينغ	stalling
ستام	stam
ستاموس	stamos
ستامير	sthamer
ستان	stan
ستاندفيست	standfest
ستاندلي	standley
ستانسبيري	stansberry
ستانسيو	stanciu
ستانفورد	stanford
ستانكيفيشيوس	stankevicius
ستانلي	stanley
ستانهوب	stanhope
ستانويك	stanwyck
ستانيسلاف	stanislav
ستاودر	stouder
ستاونتون	staunton
ستايغر	steiger
ستايلس	stiles
ستاين	stein
ستاينبيك	steinbeck
ستبس	stubbs
ستدانيك	stadnyk
ستراسجي	stracchi
ستراسر	strasser
سترافينسكي	stravinsky
ستراك	strack
ستراماتشوني	stramaccioni
ستراهوفسكي	strahovski
ستراود	stroud
سترايت	strait
سترو	straw
ستروب	stroup
ستروبل	strobel
ستروت	strutt
ستروتمان	strootman
ستروجان	straughan
ستروغاز	strogatz
سترومر	stromer
سترويسنر	stroessner
ستروينسي	struensee
ستريت	streit
ستريتر	streeter
ستريكر	stricker
ستريكلاند	strickland
ستريلر	streller
سترينجر	stringer
ستشاتشنر	schachner
ستني	stinney
ستواني	stuani
ستوب	stubb
ستوت	stott
ستوتسكي	stotsky
ستودرت	stoddert
ستورارو	sturaro
ستوراري	storari
ستورت	sturt
ستوردي	sturdee
ستورمار	stormare
ستورو	soetoro
ستوريدج	sturridge
ستوكر	stoker
ستوكس	stokes
ستوكلي	stukeley
ستوكو	stokoe
ستوكى	stuckey
ستول	stoll
ستولتنبرغ	stoltenberg
ستولمن	stallman
ستوليبين	stolypin
ستون	stone
ستونبراكر	stonebraker
ستونمان	stoneman
ستويان	stoian
ستويانوفيتش	stojanovic
ستويتشيف	stoychev
ستيبان	stjepan
ستيبانوف	stepanov
ستيبني	stepney
ستيتش	stech
ستيتية	stetie
ستيج	stieg
ستيجر	steger
ستيجلر	stigler
ستيجلز	stiglitz
ستيجيفيلت	stigefelt
ستيد	stead
ستيرلنغ	stirling
ستيرلينغ	sterling
ستيرمان	stearman
ستيرن	stern
ستيرنباخ	sternbach
ستيرنبيرغ	sternberg
ستيرنغ	staring
ستيريلني	sterelny
ستيغليتز	stieglitz
ستيفانو	stefano
ستيفانوبولوس	stephanopoulos
ستيفانوفيتش	stevanovic
ستيفاني	stephanie
ستيفانيا	stefania
ستيفن	stephen
ستيفنز	stevens
ستيفنس	steevens
ستيفنسن	stephenson
ستيفي	stevie
ستيفينارد	stievenard
ستيكلوف	steklov
ستيلا	stella
ستيلماخ	stelmach
ستيلويل	stilwell
ستيليان	stiliyan
ستين	steen
ستينبرجن	steenburgen
ستينداردو	stendardo
ستينسون	steenson
ستينكي	steineke
ستينو	steno
ستيوارت	stewart
ستيورات	stuart
سثرلاند	sutherland
سجادبور	sadjadpour
سحاب	sahab
سحنون	sahnoun
سخاو	sachau
سدرا	sedra
سدرين	bensedrine
سدير	sadir
سراقة	suraqah
سرباح	cerbah
سرجانت	sergeant
سرجون	sargon
سرجيوس	sergius
سرحان	sirhan
سردار	sardar
سردان	cerdan
سرغيف	sergeev
سرمد	sarmed
سرور	suroor
سريادو	criado
سريج	surayj
سزوكس	szucs
سزوهر	szohr
سزينتميهالي	szentmihalyi
سسكيند	susskind
سسمو	susumu
سعد	saad
سعدات	sa'adat
سعدان	saadane
سعداوي	saadawi
سعدلاييف	sadulayev
سعدي	saadi
سعود	saud
سعيد	said
سعيدي	saidi
سعيود	sayoud
سفاتوبلوك	svatopluk
سفرن	sovereign
سفري	safri
سفكارتسي	sevkaretsi
سفوبودا	svoboda
سفولوشا	sefolosha
سفيتلانا	svetlana
سفيدور	savidor
سفيردلوف	sverdlov
سفينسون	svensson
سقطي	sakati
سكاتسيل	skacel
سكاح	skah
سكاربا	scarpa
سكارسجارد	skarsgard
سكارلاتي	scarlatti
سكاروني	scarone
سكاف	skaff
سكالا	scala
سكالفارو	scalfaro
سكالوني	scaloni
سكانلان	scanlan
سكايلز	skiles
سكرايبنيك	skrypnyk
سكريابين	scriabin
سكريبس	scripps
سكريفنر	scrivener
سكرينيك	skrynnik
سكلتون	skelton
سكوت	scott
سكوتي	scotti
سكوديلاريو	scodelario
سكورزيني	skorzeny
سكورسيزي	scorsese
سكوفيت	scuffet
سكوفيلد	scofield
سكولا	scola
سكولي	sculli
سكومينا	skomina
سكي	seki
سكيابارلي	schiaparelli
سكيبل	skepple
سكيرج	skirej
سكيريت	skerritt
سكيفانو	schifano
سكيفو	scifo
سكيلاري	squillari
سكينوني	schienoni
سلاتري	slattery
سلاتفيك	slattvik
سلافتشيف	slavchev
سلافكوف	slavkov
سلافيتش	slavici
سلال	sellal
سلامة	salama
سلايت	slight
سلايتر	slater
سلبي	salbi
سلجوق	selcuk
سلدن	selden
سلرز	sellers
سلطان	sultan
سلمان	salman
سلهب	salhab
سلوتن	slotin
سلوتيماكير	slotemaker
سلوكاس	sloukas
سلوم	salloum
سليدج	sledge
سليل	salil
سليمانو	souleymanou
سليوتينا	selyutina
سماح	samah
سماكة	samaka
سمال	smale
سمتر	samater
سمر	samar
سمراوي	samraoui
سمربي	summerbee
سمرة	samra
سمرين	simreen
سمندا	szmanda
سمولنيكوف	smolnikov
سمولي	smalley
سموليت	smollett
سمون	semoun
سميبرت	smibert
سميث	smith
سميثيز	smithies
سميح	samih
سميحة	samiha
سميرة	samira
سميرتين	smertin
سميرنوف	smirnov
سميز	semiz
سميستيك	smistik
سميكة	simaika
سميليانيتش	smiljanic
سميولديرس	smeulders
سنان	sinan
سنايدر	sneijder
سنبل	sonbol
سنجر	sanjar
سنجري	sanjari
سندرسن	sinderson
سنطروق	sanatruq
سنو	snow
سنودن	snowden
سنودون	snowdon
سنوسرت	senusret
سنيت	snitt
سنيسكي	snitsky
سنيل	snell
سنيلين	snellen
سنيور	senor
سنيورلي	signorelli
سهراب	sohrab
سهل	sahl
سهير	suheir
سوابي	suwabe
سوادي	swadi
سوارتز	swartz
سواردسون	swardson
سواري	souare
سواريز	suarez
سوازو	suazo
سواغارت	swaggart
سواغر	swagger
سواكري	souakri
سوانبويل	swanepoel
سوانسون	swanson
سواه	sowah
سوايل	swaile
سوبارو	subaru
سوبرادو	sobrado
سوبوتكا	sobotka
سوبوليف	sobolev
سوبيابري	subiabre
سوبياسكي	sobieski
سوبيران	soubiran
سوبيرون	soberon
سوتا	sutta
سوترمايستر	sutermeister
سوتلوف	sotloff
سوتو	soto
سوتون	sutton
سوتير	suter
سوتيل	sutil
سوجياما	sugiyama
سوخا	socha
سوخان	soukhane
سوخديو	sookhdeo
سوخوي	sukhoi
سوخينا	sukhina
سودا	soda
سودربرغ	soderbergh
سودربيرغ	soderberg
سودرلينغ	soderling
سودوبلاتوف	sudoplatov
سودي	soddy
سوراج	suraj
سوراماريت	suramarit
سوربو	sorbo
سوربون	sorbon
سوربيير	suurbier
سورتيس	surtees
سورفينو	sorvino
سورمان	surman
سورنتينو	sorrentino
سورويا	sorolla
سوريا	soria
سوريافارمان	suryavarman
سورياك	surjak
سوريانو	soriano
سوريسكو	sorescu
سوريكوف	surikov
سورينسن	sørensen
سوزا	souza
سوزاكي	suzaki
سوزان	susan
سوزوكي	suzuki
سوس	seuss
سوسا	sosa
سوسايتا	susaeta
سوسلوف	suslov
سوسمان	sussman
سوسن	sawsan
سوسور	saussure
سوشا	sucha
سوغاتا	sugata
سوغاوارا	sugawara
سوغيورا	sugiura
سوفاري	suvari
سوفانكا	sovanka
سوفوجلو	sofuoglu
سوك	suk
سوكراتيس	socrates
سوكولوفسكي	sokolovsky
سوكونا	soukouna
سول	sol
سولانا	solana
سولانو	solano
سولت	salt
سولديرا	soldera
سولزبيرجر	sulzberger
سولسونا	solsona
سولشار	solskjær
سولومن	solomin
سولومونوف	solomonoff
سولي	sully
سولير	soler
سوليري	soleri
سوليس	solis
سوليفان	sullivan
سوماري	soumare
سومايلا	soumaila
سومباتي	szombathelyi
سومخ	soomekh
سومرز	somers
سومرست	somerset
سومرفيل	sommerville
سومرفيلد	sommerfeld
سومنر	sumner
سومورو	soomro
سوميخ	somekh
سوميل	sommeil
سونتاج	sontag
سونجو	seonjo
سوندرا	sondra
سونديم	sondheim
سونسينغ	sunsing
سونغ	sung
سونك	sonck
سونكن	sonkin
سوني	sonny
سونيا	sonia
سونيدفيلد	sonnenfeld
سونيل	sunil
سونينو	sonnino
سووبيس	swoopes
سوي	sui
سويتشيرو	soichiro
سويتنج	sweeting
سويتين	sweetin
سوير	sawyer
سويسي	swasey
سويفت	swift
سويكو	suiko
سويل	sowell
سوين	swain
سوينين	suinin
سيا	cea
سياتكا	siatka
سيار	sayyar
سياما	suyama
سياوش	siyavus
سيباستوس	sebastus
سيباستياو	sebastiao
سيبروك	seabrook
سيبريان	cibrian
سيبسي	sepsi
سيبك	seebeck
سيبولفيدا	sepulveda
سيبويا	sseppuya
سيبيري	siberie
سيبيلا	sibylla
سيتر	sitter
سيتسوكو	setsuko
سيتشينوف	sechenov
سيتكو	sitko
سيتكوفسكا	cetkovska
سيتو	seto
سيتيل	settle
سيث	seth
سيجال	segal
سيجت	suchet
سيجي	seiji
سيجيبيرت	sigebert
سيجيسموندو	sigismondo
سيد	sayed
سيدة	sayedeh
سيدكا	sidka
سيدل	seidel
سيدنهام	sydenham
سيده	sidah
سيدهم	sidhom
سيدورف	seedorf
سيدويل	sidwell
سيدياك	sidyak
سيديبي	sidibe
سيرا	serra
سيراتوس	serratos
سيرادزه	siradze
سيرالونغا	serrallonga
سيرانو	serrano
سيرتونر	serturner
سيرتيتش	sertic
سيرج	serge
سيرجيو	sergio
سيرخو	sirgo
سيردا	cerda
سيرديك	cerdic
سيرغي	sergei
سيرليف	sirleaf
سيرنان	cernan
سيرني	cerny
سيرونكوما	sserunkuma
سيرويس	sirois
سيريتوس	cerritos
سيريغو	sirigu
سيريل	cyril
سيرينا	serena
سيرينو	sereno
سيزار	cesar
سيزاريون	cesarion
سيزان	cezanne
سيزمور	sizemore
سيزو	seizo
سيساريس	cesaris
سيسلا	ciesla
سيسلنغ	sijsling
سيسما	sesma
سيسوكو	sissoko
سيسوماغا	sesumaga
سيسينيو	sisinio
سيسينيون	sessegnon
سيشييه	sechehaye
سيغاماري	sigamary
سيغان	segan
سيغريست	siegrist
سيغفرت	siegwart
سيغفريد	siegfried
سيغل	siegel
سيغورني	sigourney
سيغوندو	segundo
سيفاريد	sevareid
سيفاكوف	sivakow
سيفاكيس	sifakis
سيفاوي	sifaoui
سيفرث	seiferth
سيفريد	seyfried
سيفلينغ	siffling
سيفوك	sivok
سيفوينتس	cifuentes
سيفير	sevier
سيفيروس	severus
سيكارد	sicard
سيكافينو	schiaffino
سيكدار	sikder
سيكورد	secord
سيكورسكي	sikorsky
سيكوفا	sukova
سيكوييرا	siqueira
سيكيوليتش	sekulic
سيلا	sylla
سيلاديس	celades
سيلاس	silas
سيلان	celan
سيلر	sailer
سيلز	sills
سيلسو	celso
سيلفا	silva
سيلفان	sylvain
سيلفر	silver
سيلفرستون	silverstone
سيلفرستين	silverstein
سيلفرمان	silverman
سيلفستد	silvstedt
سيلفستر	sylvester
سيلفيا	silvia
سيلفير	sylvere
سيلفيستر	silvestre
سيلفيو	silvio
سيلكوود	silkwood
سيلكيرك	selkirk
سيلوانوف	siluanov
سيليان	cillian
سيليس	siles
سيليستيني	celestini
سيلينا	selena
سيلينج	seling
سيليني	selene
سيما	sima
سيمارو	cimarro
سيماك	semak
سيمبسون	simpson
سيمبليسيو	simplicio
سيمز	sims
سيمشوف	semshov
سيمنز	siemens
سيمنس	simmons
سيمنل	simnel
سيمو	simo
سيمور	seymour
سيمون	simon
سيموند	symond
سيموندز	simmonds
سيمونس	simons
سيمونسيلي	simoncelli
سيمونسين	simonsen
سيموني	simone
سيمونيه	simonet
سيميك	simic
سيميولي	semioli
سيميون	simeon
سيميونوف	semyonov
سيميوني	simeone
سيناترا	sinatra
سينترنيكلاس	sinterniklaas
سينتينو	centeno
سينثيا	cynthia
سينجر	singer
سينجلير	singler
سينجي	senge
سينداك	sendak
سيندي	cindy
سينديروس	senderos
سينسياريني	cinciarini
سينغ	singh
سينغلتون	singleton
سينغي	singye
سينكا	senka
سينكالا	sinkala
سينياك	signac
سينيبالدي	sinibaldi
سينيسالو	sinisalo
سينيشا	sinisa
سيهاموني	sihamoni
سيهانوك	sihanouk
سيو	siu
سيوران	cioran
سيول	seul
سيولوند	sjolund
سييف	sieff
سُكينة	sukayna
شاؤول	shaul
شاب	shapp
شاباس	schabas
شابال	chabal
شابرييه	chabrier
شابكوت	shapcott
شابور	shapur
شابوزيو	chappuzeau
شابوفالوف	shapovalov
شابوفسكي	schabowski
شابيلو	chappelow
شاترتون	chatterton
شاتلوورث	shuttleworth
شاتليه	chastellux
شاتنر	shatner
شاتوين	chatwin
شاحاك	shahak
شاحيري	chahiri
شاخلين	shakhlin
شاد	shad
شادا	shada
شادوني	shaduni
شادويل	shadwell
شادية	shadia
شارابوفا	sharapova
شاربانتييه	charpentier
شاربايكا	szarabajka
شاربونو	charbonneau
شاردان	chardin
شاردوني	chardonnet
شاردي	chardy
شاركو	charcot
شارل	charles
شارلوت	charlotte
شارمر	shermer
شارون	sharon
شارونوف	sharonov
شاريه	charest
شاستاين	chastain
شاستري	shastri
شاش	sas
شاشتر	schachter
شاشي	shashi
شاغاس	chagas
شاغال	chagall
شافران	shafran
شافني	chafni
شاقوري	chakouri
شاكر	shaker
شاكليتون	shackleton
شاكيل	shaquille
شالان	shalane
شالر	schaller
شالوروس	shalorus
شالوم	shalom
شاليط	shalit
شاليف	shalev
شامبلان	champlain
شاملو	shamloo
شاميتا	shamita
شامير	shamir
شاناهان	shanahan
شانتوم	chantome
شاندرا	chandra
شانك	schank
شانكار	shankar
شانكلي	shankly
شانكمان	shankman
شانون	shannon
شانيكا	shanica
شاه	shah
شاهابن	syahputra
شاهاكيان	shahakian
شاهد	shahade
شاهزاده	sehzade
شاهي	shahi
شاهيد	shahid
شاهيناز	shahnaz
شاوشي	chaouchi
شاول	saul
شاونا	shauna
شاوني	shawnee
شاوين	shaween
شايز	shays
شايغان	shayegan
شايك	shayk
شايكين	chaikin
شباجن	shpagin
شباط	chabat
شبانة	shabana
شبتاي	sabbatai
شبرنغر	springer
شبريكلسن	spreckelsen
شبطيني	shabtini
شبكة	shabaki
شبيرل	sperrle
شبيغل	spiegel
شبيغلر	spiegler
شتات	shatat
شتاركه	starke
شتاميتز	stamitz
شتاودنغر	staudinger
شتاوفنبرج	stauffenberg
شتاينباخ	steinbach
شتاينبرجر	steinberger
شتاينماير	steinmeier
شتراسبورج	strassburg
شترايخر	streicher
شترايش	streich
شترنهايم	sternheim
شتروبله	strobele
شتروه	stroh
شتريب	streb
شتريتماتر	strittmatter
شتودنت	student
شتولتس	stolz
شتومه	stumme
شتويبن	steuben
شتيان	zetian
شتيبانيك	stepanek
شتيرنر	stirner
شتيفاني	steffi
شتيكل	stickel
شجاعت	shujaat
شحاتة	shehata
شحدة	shehdeh
شحرور	shahrur
شخبوط	shakhbut
شداد	shaddad
شدياق	chidiac
شرابنل	shrapnel
شرابي	sharabi
شراد	cherrad
شرادها	shraddha
شراير	schreyer
شربر	schreber
شربل	charbel
شرف	sharaf
شرفة	cherfa
شرفكندي	sharafkandi
شرمان	sharman
شروزبري،	shrewsbury
شروش	shorrosh
شروف	shroff
شريدة	sharida
شريفة	sheryfa
شريفر	schrieffer
شريفير	shriver
شريكر	schreker
شعبان	shaaban
شعباني	shabani
شعيا	chaya
شعيبات	shoebat
شفارتز	schwartz
شفايتزر	schweitzer
شفيع	shafi
شفينجر	schwinger
شقية	shakaya
شقير	abushgeer
شكاريوني	scarioni
شكرتيل	skrtel
شكلوفسكي	shklovskii
شكوحي	shakuhi
شكوكو	shokoko
شكولينا	shkolina
شكوه	shikoh
شلاج	schlag
شلاف	schlaf
شلالا	shalala
شلايخر	schleicher
شلباية	shelbaieh
شلتوت	shaltut
شلح	shalah
شلفين	shelvin
شلقم	shalgham
شلمنصر	shalmaneser
شلهوب	shalhoub
شلوسبيرغ	schlossberg
شلومو	shlomo
شلوندورف	schlondorff
شليسنجر	schlesinger
شلينك	schlenk
شماس	shammas
شماسيان	chammassian
شمالفوس	schmalfuss
شمام	chemmam
شمايكل	schmeichel
شمبرلند	chamberland
شمخاني	shamkhani
شمدهوبر	schmidhuber
شمس	shams
شمسي	benchemsi
شمص	chamas
شموئيل	shmuel
شموط	shammout
شميت	schmitt
شميغا	shmyga
شميلتسر	schmelzer
شن	shin
شنايدر	schneider
شنايدرلين	schneiderlin
شنايديفولف	schindewolf
شنتارو	shintaro
شنترك	senturk
شنجول	sanchuelo
شندل	shandel
شندي	shendi
شنكن	chinkin
شنيب	shennib
شنيتز	schnetz
شنيشل	shenaishil
شنيق	chenik
شهرام	shahram
شهريار	shahriar
شهرياري	shahriari
شهزاد	shahzad
شهيب	chehayeb
شهيرة	shahira
شو	shaw
شوارتزشيلد	schwarzschild
شوارزنيجر	schwarzenegger
شواف	chawaf
شوانج	chuang
شوانك	schwank
شواي	shuai
شوبان	chopin
شوبير	shobair
شوبين	shubin
شوتز	schutz
شوتلر	schuttler
شودساك	schoedsack
شور	shore
شورت	short
شوركين	churkin
شورله	schurrle
شورنر	schorner
شوري	shorey
شوستر	schuster
شوسل	schussel
شوسون	chausson
شوغر	sugar
شوكارو	chocarro
شوكشين	shukshin
شوكلي	shockley
شوكور	sukur
شولاندير	schollander
شولتزه	schulze
شولتس	schultes
شولتنز	schultens
شولدينر	schuldiner
شولر	schoeler
شولز	schulz
شولوخوف	sholokhov
شولين	schoelen
شوماخر	schumacher
شومان	schumann
شومبيتر	schumpeter
شومبيرت	shumpert
شومو	shomu
شومي	shumi
شون	sean
شونارتس	schoenaerts
شونبورن	schonborn
شونغ	cheung
شونفيلد	schonfeld
شوهيه	shuhei
شويرينغ	scheuring
شويشة	abushwesha
شويغرمان	schwagermann
شويغو	shoygu
شويمر	schwimmer
شوينبيرج	schoenberg
شيبانغا	shipanga
شيباني	chibany
شيبرد	shepard
شيبوب	chiboub
شيبيت	chebet
شيتهام	cheetham
شيتو	shittu
شيتي	shetty
شيحا	chiha
شيحي	chihi
شيخا	cheika
شيخة	benchikha
شيدة	chida
شيدر	schaeder
شير	sher
شيراتوري	shiratori
شيرارد	sherard
شيراك	chirac
شيراكاوا	shirakawa
شيرايشي	shiraishi
شيربو	scherbo
شيربيوس	scherbius
شيرر	shearer
شيرزينغر	scherzinger
شيركو	sherko
شيرلي	shirley
شيرلين	sherlyn
شيرمان	sherman
شيرنكوف	cherenkov
شيرو	shiro
شيروف	shirov
شيريدان	sheridan
شيزكا	shizuka
شيزمان	cheesman
شيستاك	sestak
شيستنت	chestnut
شيشيروفا	chicherova
شيشيلوف	shishelov
شيعان	shae'an
شيغلر	sigler
شيغيرو	shigeru
شيغيفومي	shigefumi
شيغيو	shigeo
شيفالييه	chevalier
شيفتشوك	shevchuk
شيفروليه	chevrolet
شيقياكي	shigeaki
شيكا	chika
شيكاي	shikai
شيكتر	scheckter
شيكمان	schekman
شيلبي	shelby
شيلبيريك	chilperic
شيلتون	shelton
شيلد	shield
شيلدون	sheldon
شيلديبيرت	childebert
شيلديريك	childeric
شيلدينفيلد	schildenfeld
شيلس	shiels
شيلفن	schlieffen
شيله	scheele
شيلوبا	chiluba
شيلي	shelley
شيمادا	shimada
شيماك	simak
شيمامرا	shimamura
شيمبيرسكي	simpersky
شيمر	schiemer
شيموادا	shimowada
شيمودا	shimoda
شيموزو	shimizu
شيموس	seamus
شيمومورا	shimomura
شيمونو	shimono
شيميونيك	simunek
شين	shane
شينامي	chinami
شينج	shing
شينجي	shinji
شينزو	shinzo
شينشيلا	chinchilla
شينغ	xing
شينكاي	shinkai
شينيا	shinya
شينيتشي	shinichi
شيه	shih
شيهان	sheehan
شيودينيلي	chiudinelli
شيوري	shiori
صائب	saeb
صابر	saber
صاحب	sahib
صادقوف	sadygov
صادوقا	saduqa
صاروخان	saroukhan
صاري	sarıoglu
صالح	saleh
صالحميدزيتش	salihamidzic
صايفي	saifi
صباح	sabah
صبار	sebbar
صبارة	sabara
صبرا	sabra
صبور	sabbour
صحراوي	sahraoui
صدرالدينوفا	sadretdinova
صدقي	sedki
صدي	saddi
صعب	saab
صغيري	saghiri
صفا	safa
صفرا	safra
صفوان	safwan
صفير	sfeir
صلاح	salah
صلوخ	salloukh
صليبا	saliba
صمصام	samsam
صموئيل	samuel
صن	sun
صندل	sandal
صنصال	sansal
صهيوني	sahyouni
صوالحة	sawalha
صوان	suan
صوايا	sawaya
صوحان	suhan
صورال	soral
صوطيلو	sotelo
صوفان	soufan
صولانج	solange
صوماليا	sumaila
صوناي	sunay
صويلح	soilih
صيراط	serrat
ضاحي	dhahi
ضيفة	dayfa
ضيوف	diouf
طاسو	tasso
طاطاناكي	tatanaki
طالباني	talabani
طالبلو	talebloo
طاهر	tahir
طباطبائي	tabatabaei
طرابزون	trebizond
طراد	trad
طرفي	batarfi
طريف	tarif
طفيل	tufail
طلال	talal
طلعت	talaat
طليع	tali’a
طواطحة	tawatha
طوال	twal
طوالبة	tawalbe
طوبي	toubi
طوقان	tuqan
طولان	toulan
طولون	tulun
طيارة	tayarah
طيبي	tibi
طير	tir
ظافر	dhafer
ظاهر	zahir
ظل	zillur
عابدين	abidin
عاتكة	atikah
عادل	adel
عازار	azar
عازر	azer
عاشور	ashour
عاصي	assi
عاطف	atef
عالمكير	alamgir
عامر	amer
عاموس	amos
عاميت	amit
عايش	aaish
عايض	ayed
عباد	abbad
عبادي	obbadi
عباس	abbas
عباسي	abbasi
عبدلكي	abdelke
عبدول	abdul
عبريكا	abrika
عبلة	abla
عبيدات	obeidat
عتبان	utban
عجب	ajab
عجمي	ajami
عجيبة	ajiba
عدلي	adly
عدن	adan
عدنان	adnan
عدوس	adous
عدوية	adaweyah
عذاري	idhari
عذراء	azra
عرار	arar
عرقتنجي	aractingi
عرمان	arman
عروة	urwah
عريبي	oraibi
عريجي	araiji
عريقات	erekat
عزام	azzam
عزة	izzat
عزرا	ezra
عزرائيل	azrael
عزرية	azria
عزيز	aziz
عزيزو	azizou
عزيمان	azziman
عزيماني	azzimani
عسكري	asgari
عسيران	osseiran
عشا	asha
عشراوي	ashrawi
عشق	ishak
عشم	ashamallah
عشوش	ashoush
عصاد	assad
عصماني	osmani
عطاء	ata
عطفة	atfeh
عطوان	atwan
عطوي	atwi
عطيفات	atefat
عطيه	attiya
عفان	affan
عفروتو	afroto
عفيش	ofeich
عفيف	afif
عفيفي	afifi
عقبة	uqba
عقيلي	aghily
عكاري	akkari
عكاش	akash
عكاشة	okasha
علا	ola
علال	allal
علالو	allalou
علامة	alama
علاوي	allawi
علمدار	alemdar
علوان	alwan
علي	ali
علياء	aliya
عليخاني	alikhani
عليوان	olajuwon
علييف	aliyev
عماد	emad
عمار	ammar
عمامو	amamou
عمر	omar
عميحاي	amichai
عميرة	amira
عميس	umais
عنايتي	enayati
عنقا	anka
عهدية	ahdeya
عوام	aouam
عوز	oz
عوزي	uzi
عوض	awad
عوف	awf
عوفرا	ofra
عولقي	aulaqi
عون	awn
عوني	awni
عيان	ayan
عيد	eid
عيدي	idi
عيديد	aidid
عينوز	ainouz
غابارين	gabarain
غابالدون	gabaldon
غابر	gaber
غابري	gabri
غابريلا	gabby
غابريلارغ	gabrillargues
غابرييل	gabriel
غابرييلا	gabriela
غابرييلي	gabriele
غابولوف	gabulov
غابولويلوي	gabolwelwe
غابيتا	gabetta
غابين	gabin
غاتيت	gatete
غاتيكير	gattiker
غادة	ghada
غاديا	gadea
غاربارك	garbarek
غارث	garth
غارثيلاسو	garcilaso
غارد	garde
غاردينر	gardiner
غارزا	garza
غارسون	garson
غارسيا	garcia
غارسيس	garces
غارغو	gargo
غارفي	garvey
غارفيلد	garfield
غارلند	garland
غارنر	garner
غارنوران	garnerin
غارنييه	garnier
غارو	garro
غارودي	garaudy
غاروفالو	garofalo
غاري	gary
غاريبالد	garibald
غاريبالدي	garibaldi
غاريت	garrett
غاريدو	garrido
غاريدي	garidi
غاريزيو	garizzio
غاريسب	gariseb
غاريسون	garrison
غاريكا	gareca
غازانيغا	gazzaniga
غازي	ghazi
غاساما	gassama
غاستون	gaston
غاسر	gasser
غاسكل	gaskell
غاسيبا	gaciba
غاغا	gaga
غاغو	gago
غافانون	gavanon
غافرائيل	gavriel
غافراس	gavras
غافرانوفيتش	gavranovic
غافريلوف	gavrilov
غافريليوك	gavrilyuk
غافيلان	gavilan
غافين	gavin
غال	gale
غالا	gala
غالاتيو	galateo
غالاردو	gallardo
غالاس	gallas
غالاسيك	galasek
غالاغر	gallagher
غالان	galland
غالانتي	galante
غالانسكوف	galanskov
غالبياتي	galbiati
غالتون	galton
غالدون	galdon
غالر	galler
غالفين	galvin
غالو	gallo
غالوبا	galloppa
غالوي	galloway
غالياتسو	galeazzo
غاليتش	galic
غاليتي	galletti
غاليرا	galera
غاليسيا	galicia
غاليغو	gallego
غاليكوفيتش	galekovic
غالينا	galina
غالينوفيتش	galinovic
غاليوتو	galeotto
غامارا	gamarra
غامبوا	gamboa
غامبيريني	gamberini
غان	gan
غانثر	gunther
غانجي	ganji
غاندولفيني	gandolfini
غانز	ganz
غانزارسكي	ganczarski
غانم	ghanem
غانيبان	gagnepain
غانيون	gagnon
غاودان	gaudin
غاوديني	gaudini
غاورز	gowers
غاوري	gaury
غاوس	gauss
غاوك	gauck
غاي	guy
غايار	gaillard
غايتان	gaetan
غايتانو	gaetano
غايدوسيك	gajdusek
غايسنبيرغر	geisenberger
غايسون	gayson
غايفر	guaifer
غايل	gael
غايمار	guaimar
غايوس	gaius
غايون	gayon
غاييه	gayet
غباش	ghobash
غباغبو	gbagbo
غدار	ghaddar
غدة	ghudda
غرابار	grabar
غرابيل	grabeel
غراتسياني	graziani
غراديل	gradel
غرازيانو	graziano
غراس	grass
غراسا	graca
غراسي	grassi
غرافتون	grafton
غرافيس	graves
غرام	gram
غرامشي	gramsci
غرامليخ	gramlich
غرانات	granat
غرانادو	granado
غرانت	grant
غراندس	grandes
غرانكفيست	granqvist
غرانهولم	granholm
غرانوتشي	granoche
غرانوييرس	granollers
غراو	grau
غراوي	ghrawi
غرايم	graeme
غرزيغورز	grzegorz
غرقود	gharqoud
غرندونا	grondona
غرو	grew
غروبا	grobba
غروبر	gruber
غروبيوس	gropius
غروته	grote
غروتومسبروتن	grøttumsbraten
غروتينديك	grothendieck
غروزن	grusin
غروس	gross
غروسجان	grosjean
غروسكرويتس	großkreutz
غروسمان	grossman
غروسو	grosso
غرول	grohl
غروموف	gromov
غرونباوم	gruenbaum
غرونبرغ	grunberg
غرونديغ	grundig
غروندين	grondin
غرونهولم	gronholm
غرونيفالت	grunewald
غريبا	grippa
غريبي	ghribi
غريتري	gretry
غريتشنغ	grichting
غريتوركس	greatorex
غرير	greer
غريزلوف	gryzlov
غريساليس	grisales
غريسباخ	grisebach
غريست	greste
غريسي	gracy
غريشك	grischuk
غريشين	grishin
غريغ	greg
غريغوتي	gregotti
غريغور	gregor
غريغوريفتش	grigorevich
غريغوريني	gregorini
غريغيرا	grygera
غريفن	griffin
غريفيرز	grevers
غريكا	greki
غريكو	greco
غريلون	grillon
غرين	green
غرينبيرغ	greenberg
غريندر	grinder
غرينزبان	grynszpan
غرينغارد	greengard
غرينغراس	greengrass
غرينفيل	grenville
غرينويل	greenwell
غرينيار	grignard
غرينيت	grenet
غزاوي	ghazzawi
غزة	gaza
غزمش	gezmis
غزوان	ghazwan
غستن	gustin
غفران	ghofran
غل	gul
غلاريا	glaria
غلاسبي	glaspie
غلاسنر	glassner
غلاو	glau
غلاوبر	glauber
غلزورثي	galsworthy
غلغ	gilg
غلمية	gholmieh
غلوبرمان	glauberman
غلوتوف	glotov
غلوريا	gloria
غلوس	glos
غلوشاكوف	glushakov
غلوفر	glover
غليزس	gleizes
غليس	gillis
غليسون	gleeson
غليم	glimm
غلينتون	glinton
غليندا	glenda
غليونجي	ghalioungui
غميلين	gmelin
غناسينغبي	gnassingbe
غناكو	gnako
غنام	ghannam
غنطوس	ghantous
غنمة	ghanma
غني	ghani
غو	go
غواردادو	guardado
غوانا	guana
غوانغايتو	gwanggaeto
غوانغجونغ	gwangjong
غوانغهاي	gwanghaegun
غوانغهو	guanghu
غوبا	gobat
غوبتا	gupta
غوبرت	goeppert
غوبلز	goebbels
غوبيرتي	guberti
غوبيه	gobet
غوتاس	gutas
غوتسمانوف	gotsmanov
غوتش	gotch
غوتفريد	gottfried
غوتلف	gotthelf
غوتمان	guttmann
غوته	goethe
غوتو	goto
غوتوالد	gottwald
غوتوكو	gotoku
غوتي	gotti
غوث	guth
غوثري	guthrie
غوجوفيتسك	gojowczyk
غوخ	gogh
غود	good
غودار	godard
غودباستير	goodpasture
غودتشايلد	goodchild
غودل	godel
غودلاك	goodluck
غودلي	godley
غودمان	goodman
غوده	gude
غودوين	godwin
غوديسون	goodison
غوديلج	gudelj
غوراني	gorani
غوربيغي	gurpegui
غورديان	gordian
غورديمير	gordimer
غورغ	georg
غوركوف	gourcuff
غوركي	gorky
غوروخوفا	gorokhova
غوريتزكا	goretzka
غورينغ	goring
غوريو	goryeo
غوزان	guzan
غوزمان	guzman
غوسبوداريك	gospodarek
غوستافو	gustavo
غوسلينغ	gosling
غوشو	gosho
غوغان	gauguin
غوغنهايم	guggenheim
غوغول	gogol
غوفمان	gofman
غوفورون	govorun
غوك	guk
غولبورن	golbourne
غولجي	golgi
غولدباخ	goldbach
غولدبرغ	goldberg
غولدبلوم	goldblum
غولدر	goulder
غولدستون	goldstone
غولدشميت	goldschmidt
غولدن	golden
غولدنغ	golding
غولمييه	gaulmier
غولياس	golias
غوليد	gulaid
غوليفيتش	gulevich
غولييلمو	guglielmo
غوما	goma
غوماس	goumas
غومبريتش	gombrich
غومبز	gumbs
غوميرسيندو	gumercindo
غومييني	gumienny
غوناتاس	gonatas
غونار	gunnar
غوناريس	gounaris
غونبه	gonnohyoe
غونت،	gaunt
غونتر	gunter
غوندرا	gondra
غوندي	gondi
غونزالو	gonzalo
غونزاليس	gonzalez
غونسالفيس	goncalves
غونغورا	gongora
غونغيانغ	gongyang
غوني	goni
غوهري	gohari
غوور	goor
غويا	goya
غويتيسولو	goytisolo
غويتينك	goetinck
غويثالس	goethals
غويدو	guido
غويري	goyri
غويزا	guiza
غويكوتشيا	goycochea
غويلدرز	guelders
غويلوت	guillot
غويميز	guemez
غويور	goyer
غياسي	gyasi
غيب	gibb
غيبس	gibbs
غيبسون	gibson
غيبل	gable
غيتس	gates
غيدا	ghida
غيدرويتس	gedroitz
غيدنز	giddens
غيدولين	guidolin
غيرا	guerra
غيربا	gerba
غيرشون	gershon
غيرغيلي	gergely
غيركاليو	gercaliu
غيرمان	german
غيرهارد	gerhard
غيروميل	geromel
غيريت	guerit
غيريتس	gerets
غيريكه	guericke
غيز	ghiz
غيس	gus
غيسو	gayssot
غيغاس	gygax
غيغز	giggs
غيفت	gift
غيل	gil
غيلار	gellar
غيلارد	gillard
غيلديمايستر	gildemeister
غيلز	geels
غيلغد	gielgud
غيلفاند	gelfand
غيلفوند	gelfond
غيلفويل	guilfoyle
غيلنر	gellner
غيليام	gilliam
غيليسبي	gillespie
غيليغان	gilligan
غيليه	gillet
غيمريتش	gemmrich
غيميه	genmei
غينادي	gennady
غينريخ	geynrikh
غينزبرة	gainsborough
غينسبرغ	ginsberg
غينسبور	gainsbourg
غينسبورغ	ginzburg
غينشر	genscher
غينغ	geng
غينكل	ginkel
غينون	guenon
غينوي	genwei
غينيب	gennip
غينيس	guinness
غيودا	gioda
غيورغي	gheorghe
غيولا	gyula
غيونغجونغ	gyeongjong
غيونيا	ghionea
غيوهاتا	guihoata
غيير	geyer
فؤاد	fouad
فاب	fab
فابر	fabre
فابرا	fabra
فابرجيه	faberge
فابريانو	fabriano
فابريس	fabrice
فابريسيو	fabricio
فابريكيوس	fabricius
فابريني	fabbrini
فابي	fabi
فابيانو	fabiano
فابياني	fabiani
فابين	fabien
فابيو	fabio
فابيوس	fabius
فات	fat
فاتن	faten
فاتو	fatou
فاتون	fatton
فاتي	faty
فاتيتش	fatic
فاتيمو	vattimo
فاجيه	faguet
فاجيولي	fagioli
فاخوري	fakhoury
فادي	fadi
فارابيلو	farabello
فاراداي	faraday
فاراس	varas
فارايو	varallo
فاربورغ	warburg
فارتوون	fartuun
فارجاو	varejao
فاردين	fardeen
فارشفسكي	warschawski
فارغا	varga
فارفان	farfan
فارفيلد	fairfield
فاركا	farka
فاركاش	farkas
فارلي	farley
فارلين	varglien
فارما	varma
فارمان	farman
فارمر	farmer
فارميغا	farmiga
فارنزوورث	farnsworth
فارني	varney
فارودو	fa'arodo
فاروق	farouk
فارولت	varrault
فاريا	faria
فارياس	farias
فاريس	faris
فاريل	farrell
فاريلا	varela
فارينا	farina
فازاري	vasari
فازر	fazer
فازلاغيتش	fazlagic
فاسبرغ	wassberg
فاسبندر	fassbender
فاستو	vasto
فاسرمان	wassermann
فاسكو	vasco
فاسكونسيلوس	vasconcelos
فاسنستوف	vasnetsov
فاسيلي	vasily
فاسيلييف	vassiljev
فاشون	vachon
فاطمة	fatima
فاغرهولم	fagerholm
فاغنر	wagner
فافالي	favalli
فاككاريلا	vaccarella
فاكوندو	facundo
فالابا	falappa
فالاخ	wallach
فالانا	falana
فالاهي	falahee
فالترماير	faltermeyer
فالتز	waltz
فالتويانو	faltoyano
فالتي	valetti
فالدانو	valdano
فالدسميلر	waldseemuller
فالدهايم	waldheim
فالديت	valdet
فالدير	valdeir
فالديراما	valderrama
فالديز	valdes
فالديفيسو	valdivieso
فالديفيوري	valdifiori
فالزهوفر	walzhofer
فالس	valls
فالسالفا	valsalva
فالسر	walser
فالفيردي	valverde
فالكنهاين	falkenhayn
فالكو	falco
فالكونر	falconer
فالكوني	falcone
فالكي	falque
فالميرو	valmiro
فالنتاين	valentine
فالنتي	valenti
فالنتين	valentin
فالنتينو	valentino
فالنتينيان	valentinian
فالنر	wallner
فالنس	valens
فالنسي	valensi
فالنسيا	valencia
فالنشتاين	wallenstein
فالوا	valois
فالون	fallon
فالويل	falwell
فالي	valle
فالياني	valiani
فاليرو	valero
فاليريو	valerio
فالينت	valiant
فالينزويلا	valenzuela
فاليير	fallieres
فان	van
فانا	fana
فانبرة	vanbrugh
فانتشوني	fanchone
فانتيني	fantini
فاندام	vandam
فاندر	vander
فاندرفورت	vandervoort
فاندل	fandel
فاندنبرغ	vandenberg
فاندورين	vandooren
فانديفير	vandeveer
فانديفيير	vandeweyer
فاندينبيرغ	vandenbergh
فاندينديل	vandendaele
فانس	vance
فانسومرن	vansummeren
فانسيلي	facinelli
فانغا	vanga
فانغزهو	fangzhuo
فانك	funk
فانكوفر	vancouver
فانهانن	vanhanen
فانو	fano
فاني	fanny
فانينبورغ	vanenburg
فانينغ	fanning
فاهرمان	fahrmann
فاهل	vahl
فاهي	fahey
فاوري	faure
فاوست	fawcett
فاوستو	fausto
فاولابر	faulhaber
فاولر	fowler
فايا	falla
فايتسكر	weizsacker
فايتنغ	fighting
فايدنفيلر	weidenfeller
فايراباند	feyerabend
فايرينن	vayrynen
فايسمولر	weissmuller
فايفر	pfeiffer
فايلر	weiler
فاينجر	vaihinger
فاينس	fiennes
فاينمان	feynman
فايواسو	fa'aiuaso
فاييه	faye
فتاح	fatah
فتحي	fathi
فتحية	fathia
فتزجيرالد	fitzgerald
فتستاين	wettstein
فتشيزاكي	fuchizaki
فتفت	fatfat
فتيل	fateel
فتيني	ftayni
فجيمرا	fujimura
فخنر	fechner
فدشنكو	fedtschenko
فدوى	fadwa
فديكند	wedekind
فرات	fırat
فراديك	fradique
فراسكو	frasco
فراشري	frasheri
فران	fran
فرانا	frana
فرانتز	frantz
فرانتيشيك	frantisek
فرانجيتش	franjic
فرانز	franz
فرانزل	franzl
فرانسوا	francois
فرانسواز	francoise
فرانسيا	francia
فرانسيس	francis
فرانسيسكو	francisco
فرانسيسكولي	francescoli
فرانسيسي	francisci
فرانش	franch
فرانشيسكو	francesco
فرانشيني	francini
فرانك	frank
فرانكس	franks
فرانكلاند	frankland
فرانكلين	franklin
فرانكو	franco
فرانكيتشيني	franceschini
فراو	frau
فراونهوفر	fraunhofer
فرايل	friel
فرح	farah
فرحان	farhan
فرحناز	farahnaz
فرد	fred
فردندال	fredendall
فردوس	ferdoos
فرديمان	vardiman
فرزات	farzat
فرس	faras
فرفل	werfel
فرلان	verlaine
فرليتو	ferlito
فرميش	vermeersch
فرنادسكي	vernadsky
فرنجية	frangieh
فرنر	werner
فرنسا	france
فرهاد	farhad
فرودنثال	freudenthal
فروسارت	froissart
فروست	frost
فروشانتيه	frusciante
فروليش	frohlich
فروم	fromm
فرويد	freud
فرويدفيلدت	frojdfeldt
فرويلا	fruela
فريتاس	freitas
فريتز	fritz
فريث	frith
فريج	vrij
فريجيريو	frigerio
فريحة	freiha
فريدا	freida
فريدرش	frederick
فريدريتش	friedrich
فريدريكس	fredericks
فريدريكسون	fredriksson
فريدزون	fridzon
فريدل	friedel
فريدلاندر	friedlander
فريري	freire
فريز	friese
فريس	friis
فريستشي	freschi
فريش	frisch
فريعة	friaa
فريك	frick
فريليني	ferlini
فريمان	freeman
فرينتزين	frentzen
فرينجز	frings
فريند	friend
فرينش	french
فرينل	fresnel
فريني	vreni
فريولي	friuli
فريير	freier
فزنين	vesnin
فستنغر	festinger
فستنفلد	wustenfeld
فسيفولود	vsevolod
فصاح	fazah
فضلان	fadlan
فضيل	fazeel
فطناسي	fatnassi
فغالي	feghali
فقراء	foukara
فقير	fekir
فك	fuck
فكامي	fukami
فكتور	victor
فكرت	fikret
فكروش	fegrouche
فكرون	fakroun
فلاته	fallatah
فلاتوف	flatow
فلاحيان	fallahian
فلار	vlaar
فلاغ	flagg
فلافيو	flavio
فلاق	fellag
فلاكه	flake
فلامستيد	flamsteed
فلامينيوس	flaminius
فلاميون	flamion
فلاناغان	flanagan
فلاندرز	flanders
فلانري	flannery
فلانس	valance
فلانو	flano
فلاهوف	vlahov
فلاهيرتي	flaherty
فلايم	flame
فلبس	phleps
فلكسنر	flexner
فلورا	flora
فلوران	florent
فلورنتن	florentin
فلورنتينو	florentino
فلورنثيو	florencio
فلورنس	florence
فلورنسكي	florensky
فلورو	floro
فلوريان	florian
فلوريس	flores
فلورين	florin
فلورينتين	florentin
فلورينزي	florenzi
فلوريو	florio
فلوكاري	floccari
فلويد	floyd
فليتر	flitter
فليتشر	fletcher
فليحان	fleihan
فليروف	flyorov
فليس	benflis
فليشر	fleischer
فليشمان	fleischmann
فليكر	flecker
فليمنج	fleming
فلين	flynn
فلينترمان	flinterman
فليندرز	flinders
فليني	fellini
فمينوري	fuminori
فنتسل	wenceslaus
فنتوريني	venturini
فنتون	fenton
فنغ	feng
فنلون	fenelon
فنون	fignon
فنيس	funes
فهر	fihr
فهرنهايت	fahrenheit
فواكومبوتو	fuakumputu
فوبيرت	faubert
فوت	foote
فوتري	futre
فوتريخ	wuthrich
فوتسيس	votsis
فوتشس	fuchs
فوتكه	wuttke
فوتو	futo
فوتورينو	fottorino
فوجيا	foggia
فوجيتا	fujita
فوجيشيما	fujishima
فوجيموري	fujimori
فوجيو	fujio
فوجيوارا	fujiwara
فوربس	forbes
فورتادو	furtado
فورتاين	fortuyn
فورتسكو	fortescue
فورتون	fortun
فورتوني	fortuny
فورتونيس	fortounis
فورتي	fortey
فورتيس	fortes
فورد	ford
فورد	forde
فورديكرز	voordeckers
فورساه	vorsah
فورستال	forstall
فورستر	forster
فورسكول	forsskal
فورسمان	forssmann
فورسيث	forsyth
فورسيل	forssell
فورلونغ	furlong
فورلين	forlin
فورنارا	fornara
فورنوكس	furneaux
فورنون	vurnon
فورنييه	fournier
فورهوف	voorhoof
فورونوي	voronoy
فورونين	voronin
فوريس	fores
فوريست	fourest
فوريستيري	forestieri
فوريسون	faurisson
فوريلون	vorilhon
فورينو	furino
فوزنياكي	wozniacki
فوزي	fawzi
فوزية	fawzia
فوساتي	fossati
فوسكوبويفا	voskoboeva
فوسكوبوينيكوف	voskoboinikov
فوش	foch
فوشي	foschi
فوغ	fogh
فوغارتي	fogarty
فوغان	vaughan
فوغت	vogt
فوغلفايدي	vogelweide
فوكر	fokker
فوكسي	foxy
فوكنر	faulkner
فوكوا	fuqua
فوكوشيما	fukushima
فوكوماتسو	fukumatsu
فوكومي	fukumi
فوكوي	fukui
فوكوياما	fukuyama
فولاذ	fulad
فولاند	volland
فولاندري	volandri
فولانسبي	follansbee
فولتس	foltz
فولتمان	woltman
فولر	fuller
فولسكي	wolski
فولطشكوف	voltchkov
فولغر	folger
فولفرام	wolfram
فولفغانغ	wolfgang
فولفنبوتل	wolfenbuttel
فولكمان	volkmann
فولكوف	wolkoff
فولكي	fulci
فولمر	vollmer
فولمير	follmer
فولودارسكي	volodarsky
فولي	foley
فوليت	follett
فوموسا	fumusa
فومي	fumi
فوميتو	fumito
فوميهيكو	fumihiko
فوميو	fumio
فون	von
فوناجي	fonagy
فونتان	fontan
فونتانه	fontane
فونتانيلو	fontanello
فونتين	fontaine
فوندا	fonda
فوندرليش	wunderlich
فوندريست	fondriest
فونزاليدا	fuenzalida
فونست	fonst
فونسي	fonsi
فونسيكا	fonseca
فونلانثون	vonlanthen
فونليه	vonleh
فونيني	fognini
فوهامي	fouhami
فوول	fool
فوي	foye
فويتكوفياك	wojtkowiak
فويتينس	wuytens
فويسن	voisin
فويفودسكي	voevodsky
فوينتي	fuente
فوينمايور	fuenmayor
فوينيتش	voynich
فياتشيسلاف	vyacheslav
فيالار	vialar
فيالبه	valbe
فيانا	viana
فيانت	fieandt
فياني	viani
فيبر	weber
فيبوناتشي	fibonacci
فيبيغر	fibiger
فيترستورم	wetterstrom
فيتزجيبون	fitzgibbon
فيتزجيرالد	fitzgerald
فيتزوالتر	fitzwalter
فيتش	fitch
فيتشر	fischer
فيتشنياريك	wichniarek
فيتغنشتاين	wittgenstein
فيتكلو	wetklo
فيتلاسيل	vytlacil
فيتور	vitor
فيتورينو	vitorino
فيتون	fitton
فيتيبالدي	fittipaldi
فيتيزنجر	fitzinger
فيث	faith
فيجسا	fejsa
فيخس	weichs
فيدا	vida
فيدان	fidan
فيدرير	federer
فيدريكي	federici
فيدل	fidel
فيدلر	fiedler
فيدمر	widmer
فيدوتشيا	feduccia
فيدورتشينكو	fedorchenko
فيديريكا	federica
فيديريكو	federico
فيديونينسكي	fedyuninsky
فيرا	vera
فيراتا	ferrata
فيراتغ	ferratge
فيراتي	verratti
فيرارا	ferrara
فيراري	ferrari
فيراريس	ferraris
فيرانكوسكي	virrankoski
فيرايرا	ferreyra
فيربانكس	fairbanks
فيربير	werber
فيربينسكي	verbinski
فيرتل	viertl
فيرث	firth
فيرجاسولا	vergassola
فيرجيس	verges
فيرجيل	virgil
فيرجينيا	virginia
فيرداسكو	verdasco
فيردونا	verdone
فيردونك	verdonk
فيردي	verdi
فيرديس	virdis
فيرساتشي	versace
فيرسيب	versyp
فيرغا	verga
فيرغارا	vergara
فيرغسون	ferguson
فيرغوس	fergus
فيركوتر	vercoutre
فيركيرك	verkerk
فيرل	ferrell
فيرلوسيو	ferlosio
فيرلي	fairley
فيرمايلين	vermaelen
فيرمي	fermi
فيرمير	vermeer
فيرمين	firmin
فيرناندو	fernando
فيرنانديز	fernandez
فيرنون	vernon
فيرهايخ	verhaegh
فيرهلست	verhulst
فيرهويفن	verhoeven
فيرهيرين	verheyen
فيرونيتي	ferronetti
فيرونيسي	veronesi
فيرونيكا	veronica
فيريت	feret
فيرير	ferrer
فيريري	ferreri
فيريغنو	ferrigno
فيريللي	ferilli
فيرين	viren
فيرينتس	ferenc
فيرينغ	eyring
فيريني	ferrini
فيزاردي	fezzardi
فيزن	faison
فيزيكيلا	fisichella
فيس	wyss
فيساج	visage
فيسترجارد	westergaard
فيسترفيله	westerwelle
فيسدايك	vestdijk
فيسك	fisk
فيسكونتي	visconti
فيسل	wessel
فيسنر	wiessner
فيسنينا	vesnina
فيسوتسكي	vysotsky
فيسوكي	wysocki
فيسيتور	visitor
فيسينتيني	visentini
فيسيندين	fessenden
فيش	fish
فيشته	fichte
فيشليني	wesselenyi
فيشمان	fichman
فيشنفسكي	vyshnevskyi
فيصل	faisal
فيغا	vega
فيغاري	figari
فيغنبوم	feigenbaum
فيغوتسكي	vygotsky
فيغولي	feghouli
فيغويروا	figueroa
فيغيريدو	figueiredo
فيغيريس	figueres
فيفالدي	vivaldi
فيفي	fifi
فيكاندير	vikander
فيكتوريا	victoria
فيكتوريانو	victoriano
فيكتورينو	victorino
فيكسيلبيرغ	vekselberg
فيكنر	fichtner
فيلاسكو	velasco
فيلاسكيز	velasquez
فيلاكامبا	villacampa
فيلاند	wieland
فيلاندر	philander
فيلانويفا	villanueva
فيلاني	villani
فيلبس	phelps
فيلبي	philby
فيلتروني	veltroni
فيلتمان	veltman
فيلدز	fields
فيلدكه	veldeke
فيلدمان	feldman
فيلدي	velde
فيلدينغ	fielding
فيلر	feller
فيلس	wels
فيلسنر	felsner
فيلشتيتر	willstatter
فيلشنر	filchner
فيلفورت	vilfort
فيلكس	felix
فيلموتس	wilmots
فيلمور	fillmore
فيلهابر	feilhaber
فيلوتا	villota
فيليبالد	willibald
فيليبي	felipe
فيليبيني	filippini
فيليسيانو	feliciano
فيليشيا	felicia
فيليكس	felix
فيليموفسكي	wilimowski
فيليو	filho
فيليون	fillion
فيميرلينج	femerling
فينا	veena
فينابلز	venables
فينان	finnan
فينانت	veinante
فينتوري	venturi
فينتولرا	ventolra
فينتي	fenty
فيندت	wendt
فيندونو	feindouno
فيندي	fendi
فينر	fenner
فينسنت	vincent
فينش	finch
فينشر	fincher
فينغر	finger
فينكلستاين	finkelstein
فينكيلمان	winkelman
فينمان	veneman
فينود	vinod
فينوس	venus
فينوكوروف	vinokourov
فيني	feeney
فينيال	vignal
فينيدي	finidi
فينيزيانو	veneziano
فينيمان	vennemann
فينين	fenin
فيه	veh
فيهير	feher
فيوتشيني	feutchine
فيودجو	feudjou
فيودور	fyodor
فيودورفنا	feodorovna
فيودوروف	fyodorov
فيور	feore
فيورافانتي	fioravanti
فيورباخ	feuerbach
فيوري	fiori
فيوريلو	fiorillo
فيورينا	fiorina
فيوشانج	vieuchange
فيولا	viola
فيوليتا	violeta
فييث	vieth
فييرا	vieira
فييرجوود	vierchowod
فييرو	fierro
فکوهی	fakouhi
قابل	qabel
قابيل	kabil
قادر	kader
قاسملو	ghassemlou
قاسمي	gasmi
قاشوش	qashoush
قالانجو	qalanjo
قباذ	kavadh
قبرص	cyprus
قبها	kabha
قتادة	qatada
قتلمش	qutulmish
قتيلة	qutaylah
قحطان	qahtan
قراصو	carasso
قرداحي	kurdahi
قرنق	garang
قريع	qurei
قسطنطين	constantine
قسيس	kassis
قشوع	kashua
قصي	qusai
قصير	kassir
قطب	qutb
قلادة	kelada
قلج	kilij
قلحية	galhia
قمبيز	cambyses
قندلفت	kandalaft
قنديل	qandil
قنواتى	kanawati
قهواتي	kahawaty
قوام	qavam
قوانغ	guangcheng
قوبلاي	kublai
قويدر	qwaider
قيراط	guirat
قينان	qenan
كا	ka
كابادزه	kapadze
كاباروس	caparros
كاباس	kabbas
كاباسو	cabassut
كابانياس	cabanas
كاباييرو	caballero
كابديفايل	capdeville
كابرال	cabral
كابرياتي	capriati
كابريرا	cabrera
كابريني	cabrini
كابشاو	capshaw
كابل	cabell
كابوانو	capuano
كابوتي	capote
كابور	kapoor
كابورن	caporn
كابوريك	kaburek
كابوريه	kabore
كابوكالو	caboclo
كابونغو	kabongo
كابيروسي	capirossi
كابيزاس	cabezas
كابيلكا	kobilka
كابين	capin
كاتالان	catalan
كاتالدي	cataldi
كاتالينسكي	katalinski
كاتاليني	cattalini
كاتاياما	katayama
كاترال	cattrall
كاتري	katri
كاترين	catherine
كاتزنبرج	katzenberg
كاتسبي	catesby
كاتسكي	katsuki
كاتسنوسكي	katsunosuke
كاتسهيسا	katsuhisa
كاتسو	katsu
كاتسواكي	katsuaki
كاتسوجي	katsuji
كاتسوهيرو	katsuhiro
كاتل	cattell
كاتلون	kettlun
كاتليت	catlett
كاتمول	catmull
كاته	katte
كاتوكوف	katukov
كاتونغو	katongo
كاتي	katie
كاتينا	katina
كاثكارت	cathcart
كاجان	kagan
كاجي	kaji
كاجياما	kagayama
كاجيورا	kajiura
كادار	kadar
كادشمان	kadashman
كادواكي	kadowaki
كادوجان	cadogan
كادورنا	cadorna
كادى	kadee
كادي	cady
كادينوك	kadeniuk
كار	carr
كارا	kara
كارات	karat
كاراجيو	caragiu
كاراغونيس	karagounis
كاراموكو	karamoko
كاران	karan
كارايان	karajan
كارب	karp
كاربا	karba
كارباتي	karpati
كارباخال	carbajal
كاربجياني	carpegiani
كاربر	carper
كاربلوس	karplus
كاربنتر	carpenter
كاربونيرو	carbonero
كاربونيل	carbonell
كاربيلان	carpelan
كاربينتيرو	carpintero
كاربينكو	karpenko
كارتر	carter
كارترايت	cartwright
كارتن	cartan
كارتين	kurten
كارتييه	cartier
كارداشيان	kardashian
كاردان	cardin
كاردوزو	cardozo
كاردوس	cardus
كاردوسو	cardoso
كاردون	cardone
كاردونا	cardona
كارديلينهو	cardellino
كارديناس	cardennas
كاردينالي	cardinale
كاردينوسا	cardenosa
كارسلي	carsley
كارسون	carson
كارسييري	carcieri
كارفالو	carvallo
كارفاليو	carvalho
كارفر	carver
كارل	carl
كارلا	carla
كارلسن	carlsen
كارلسون	carlsson
كارلفلت	karlfeldt
كارلهاينز	karl
كارلو	carlo
كارلوفيتش	karlovic
كارلومان	carloman
كارلوند	carlund
كارلي	carly
كارليباخ	carlebach
كارليسل	carlisle
كارليل	carlyle
كارم	karem
كارماك	carmack
كارمونا	carmona
كارميلو	carmelo
كارن	karen
كارناب	carnap
كارنجي	carnegie
كارنهان	carnahan
كارنيلجيا	carniglia
كارهان	karhan
كارو	caro
كاروسو	caruso
كارول	carroll
كارولتون	carrollton
كارولي	karoly
كاروليس	carolis
كارولين	caroline
كارون	caron
كارونغا	karounga
كارياكن	karjakin
كاريبيرت	charibert
كاريراس	carreras
كاريزما	charisma
كاريزو	carrizo
كاريس	caresse
كاريك	carrick
كاريكيزي	karekezi
كاريكين	karekin
كاريليرو	carrilero
كاريموف	karimov
كاريمي	karyme
كارين	karin
كاريني	carini
كاريه	carre
كاريير	carriere
كازابلانكاس	casablancas
كازارين	casarin
كازان	kazan
كازانكينا	kazankina
كازانوفا	casanova
كازهيكو	kazuhiko
كازو	kazuo
كازوشيجي	kazushige
كازوكي	kazuki
كازيمير	casimir
كازينسكي	kaczynski
كاسا	scassa
كاسات	cassatt
كاسادو	casado
كاساديسوس	casadesus
كاسارين	casarin
كاساس	casas
كاساغراندي	casagrande
كاسافيتز	cassavetes
كاساندرا	cassandra
كاسانو	cassano
كاساني	cassani
كاساهارا	kasahara
كاسب	kasseb
كاسبرسكي	kaspersky
كاستان	castan
كاستانو	castano
كاستانيو	castagno
كاستر	custer
كاسترو	castro
كاستلر	kastler
كاستلنوفو	castelnuovo
كاستنر	kastner
كاستيلازي	castellazzi
كاستيلان	castellan
كاستيلو	castillo
كاستيلين	castelen
كاستين	kastein
كاسكارينو	cascarino
كاسل	cassel
كاسنر	kassner
كاسوسولا	kasusula
كاسولا	kasola
كاسولي	casoli
كاسونا	casona
كاسوندي	kasonde
كاسيتي	cassetti
كاسيراجي	casiraghi
كاسيرتا	caserta
كاسيرو	casero
كاسيميرو	casimiro
كاسين	casin
كاسيني	cassini
كاش	cash
كاشغري	kashgari
كاصد	gassid
كاطع	gatea
كاغاوا	kagawa
كاغني	cagney
كاغو	kago
كافالي	cavalli
كافاليرو	cavaleiro
كافاليري	cavalieri
كافانا	cavanna
كافاناه	kavanagh
كافانيليس	cavanilles
كافكا	kafka
كافلنيكوف	kafelnikov
كافنديش	cavendish
كافنر	kavner
كافوتيكا	kafoteka
كافومبا	kafoumba
كافياري	cavallari
كافيدس	kaviedes
كافيناغي	cavenaghi
كافيه	cafe
كاك	kac
كاكازو	kakazu
كاكستون	caxton
كاكوتا	kakuta
كاكوما	kakuma
كاكويه	kakuei
كاكياتوري	cacciatore
كاكيهارا	kakihara
كالا	kalla
كالابريا	calabria
كالاترافا	calatrava
كالاثيس	calathes
كالافات	calafat
كالاندريا	calandria
كالاهان	callaghan
كالايو	calaio
كالتاك	kaltack
كالتينبرونر	kaltenbrunner
كالدر	calder
كالدويل	caldwell
كالديرا	caldera
كالديرولا	caldirola
كالديرون	calderon
كالديري	caldere
كالديكوت	caldicott
كالستروم	kallstrom
كالفيت	calvet
كالفين	calvin
كالفينو	calvino
كالفينيس	kalvenes
كالمان	kalman
كالو	kalou
كالواي	calloway
كالون	kallon
كاليا	calia
كاليانيوتيس	kallianiotes
كاليب	caleb
كاليخا	calleja
كاليشر	kalischer
كاليغاريس	caligaris
كاليغيوري	caligiuri
كاليف	califf
كاليكو	calico
كالين	callen
كالينبيرغ	kahlenberg
كالينكوف	calincov
كالينيكوس	callinicos
كالينين	kalinin
كام	cam
كاماتشو	camacho
كامارا	camara
كامارينا	camarena
كامان	kaman
كامانو	kamano
كامب	camp
كامبامبا	kampamba
كامبانا	campana
كامبانيولو	campagnolo
كامبرونيرو	cambronero
كامبريا	cambrea
كامبس	camps
كامبفرت	kaempfert
كامبو	campo
كامبوامور	campoamor
كامبوريس	camporese
كامبوس	campos
كامبي	camby
كامبيل	campbell
كامبيون	campion
كامران	kamran
كامكيه	kamke
كامن	kamen
كامهانج	khamhaeng
كامو	camus
كاموسو	camusso
كاموف	kamov
كاموناس	camunas
كاميا	kamiya
كاميرر	kammerer
كاميرون	cameron
كاميريتشس	kammerichs
كاميلا	camilla
كاميليا	kamilia
كامينزيند	camenzind
كامينيرو	caminero
كاميهاميها	kamehameha
كانا	kana
كاناداس	canadas
كانافارو	cannavaro
كاناكاريديس	kanakaredes
كاناليس	canales
كانايا	kanaya
كانتاريل	cantareil
كانتربري	canterbury
كانتروفيتش	kantorovich
كانتو	canto
كانتونا	cantona
كانتي	kante
كانتيلون	cantillon
كاندر	kander
كاندريفا	candreva
كاندل	kandel
كانديا	kandia
كانديلاكي	kandelaki
كانسوكي	kansuke
كانغراندي	cangrande
كانغوا	kangwa
كانفوري	kanfory
كانفيلد	canfield
كانكر	cankar
كانليس	kanellis
كانمان	kahneman
كانوبيو	canobbio
كانوت	cnut
كانوتيه	kanoute
كانوث	knuth
كانوفا	canova
كانون	cannon
كانونيكا	canonica
كانيجيا	caniggia
كانيرا	caneira
كانيزا	caniza
كانيزاريس	canizares
كانيل	kanel
كانيلا	canella
كانينغ	canning
كانينغهام	cunningham
كانيني	canini
كانيوتو	cagnotto
كانييه	kanye
كاهانا	kahane
كاهاناموكو	kahanamoku
كاهانوف	kahanoff
كاوادا	kawada
كاواسي	kawase
كاواف	kavaf
كاواكامي	kawakami
كاواموتو	kawamoto
كاوامورا	kawamura
كاوبر	kuyper
كاوتسكي	kautsky
كاوثون	cawthon
كاورو	kaoru
كاوري	kaori
كاوريسمكي	kaurismaki
كاوشيك	kaushik
كاول	cowell
كاولز	cowles
كاوندا	kaunda
كاي	kay
كاي	kaye
كايا	kaya
كايانو	kayano
كايت	kate
كايتل	keitel
كايتلي	kightly
كايتو	kaito
كايجي	kaiji
كايدا	kaida
كايرني	cairney
كايس	cayce
كايسن	kaysen
كايسيب	khaiseb
كايشو	kaishu
كايكا	kaika
كايكو	kaiko
كايل	kyle
كايمبي	kaimbi
كاين	cain
كايوتي	cayouette
كبة	kubba
كبير	kabeer
كبيري	kabiri
كتاب	kuttab
كتبغا	kitbugha
كتساف	katsav
كتسس	kitsis
كتلين	caitlyn
كتيلة	ktila
كحالة	kahala
كحيل	kahil
كدي	keddie
كرات	kratt
كراج	cragg
كرادوك	craddock
كراسكو	carrasco
كراسيتش	krasic
كراسيف	karasev
كراسينسكى	krasinski
كراش	crash
كرافتس	crafts
كرافتشوك	kravchuk
كرافن	craven
كرافيتز	kravitz
كرافيرو	cravero
كرال	krall
كرالوفيتس	kralovec
كرامنيك	kramnik
كرامي	karami
كرانزلاين	kraenzlein
كرانش	cranch
كرانكل	krankl
كرانمر	cranmer
كراوفورد	crawford
كرايتشك	krajicek
كرايزلبرغ	krayzelburg
كرايستون	crayston
كربوسينا	karbonopsina
كربول	karboul
كربيجن	corbijn
كرد	kurd
كرزاي	karzai
كرسبي	crispi
كرفييل	kerviel
كركلا	caracalla
كركي	karaki
كركيتش	krkic
كرليجا	krleza
كرماش	krmas
كرمالي	kermali
كرو	crowe
كرواتو	croatto
كروبا	krupa
كروبي	karroubi
كروتشلوو	crutchlow
كروجر	kroeger
كرودب	crudup
كروز	cruz
كروزار	kreuzer
كروسات	crusat
كروساس	crosas
كروسان	crossan
كروسول	crosswell
كروسوهيتي	crosswhite
كروغر	kruger
كروفت	croft
كروك	kroc
كروكر	crocker
كروكس	crookes
كروكنبيرغ	krukenberg
كرولدروب	krøldrup
كرولوف	krolow
كرومويل	cromwell
كرومي	chromy
كروناور	kronauer
كرونكايت	cronkite
كرونكويست	cronquist
كرونوسلاف	krunoslav
كرونين	cronin
كرويغر	kruger
كروينك	kroenke
كريانغا	creanga
كريبس	krebs
كريبيلن	kraepelin
كريتز	cretz
كريتشمان	kretschmann
كريتشيتو	criscito
كريري	kariri
كريس	chris
كريسبو	crespo
كريست	crist
كريستا	christa
كريستال	crystal
كريستالدو	cristaldo
كريستالر	christaller
كريستانتي	cristante
كريستوفاو	cristovao
كريستوفر	christopher
كريستوفورو	cristoforo
كريستوفوري	cristofori
كريستيان	christian
كريستيانسين	christiansen
كريستيانو	cristiano
كريستيفا	kristeva
كريستين	christine
كريستينسن	christensen
كريسوستوم	chrysostome
كريسيس	chrysis
كريشان	kreishan
كريشنا	krishna
كريفنكوفسكي	crvenkovski
كريفي	grevy
كريكمان	crickmer
كريلوف	krylov
كريم	karim
كريمرز	kremers
كريملو	karimloo
كرينا	crenna
كرينغه	kringe
كريوزيجير	kreuziger
كريوك	kreuk
كزاز	guezzaz
كساو	kusao
كسباريان	kasparian
كستنر	kastner
كسحي	kashi
كسروي	kasravi
كسرى	khosrow
كسنجر	kissinger
كسيانغ	xiang
كسيداكيس	xydakis
كشتيلياش	kashtiliash
كشدان	kazhdan
كشك	kishk
كشكش	keshkesh
كشلاكجي	kachlakji
كشمولة	kashmoula
كعب	ka'b
كغيميا	kugimiya
كفاشناك	kvasnak
كفتارو	kuftaro
كفوري	kfoury
كل	gul
كلاب	kilab
كلابتون	clapton
كلابرتون	clapperton
كلات	klatt
كلاتنبورغ	clattenburg
كلارا	clara
كلارك	clark
كلاركسون	clarkson
كلارنس	clarence
كلاري	clary
كلاريزا	klariza
كلاريشي	clarice
كلاس	kallas
كلاسكوك	glascock
كلاسون	clason
كلاسي	kallasi
كلاشنيكوف	kalashnikov
كلافام	clapham
كلافلن	claflin
كلافيل	clavel
كلافينو	klaveno
كلامب	clamp
كلامبورغ	klamburg
كلانسي	clancy
كلاو	klawe
كلاوبيرغ	clauberg
كلاوديا	claudia
كلاوديوس	claudius
كلاوزفيتز	clausewitz
كلاوس	klaus
كلاي	clay
كلايتون	clayton
كلايد	clyde
كلايدرمان	clayderman
كلايست	kleist
كلايسترز	clijsters
كلايسين	claesen
كلايسينز	claessens
كلايفرت	kluivert
كلاين	klein
كلبس	klebs
كلثوم	kulthum
كلدة	kalada
كلديريم	kaldırım
كلستيل	klestil
كلغ	clegg
كلف	kalaf
كلفت	kalfat
كلفز	klaws
كلنجر	klinger
كلوب	klopp
كلوبشتوك	klopstock
كلوت	clot
كلوتشكوفا	klochkova
كلوتير	chlothar
كلود	claude
كلودن	kloden
كلوديل	claudel
كلوزيل	cluzel
كلوزيه	cluzet
كلوسن	clausen
كلوسي	clossey
كلوغ	klug
كلوغمان	klugman
كلوفت	kluft
كلومسكي	chlumsky
كلووري	clowry
كلي	klee
كليبر	cleber
كليتزينج	klitzing
كليروت	clairaut
كليري	cleary
كليزان	klizan
كليشي	clichy
كليغمان	kligman
كليفت	clift
كليفتون	clifton
كليفرلي	cleverley
كليفنجر	clevenger
كليم	kalim
كليمان	clement
كليمبنر	klempner
كليمت	klimt
كليمنت	clement
كليمنتس	clements
كليموفيتش	klimowicz
كليمينز	clemens
كلينت	clint
كلينتون	clinton
كلينجوفر	klinghoffer
كلينغ	kling
كلينه	kleine
كليوباترا	cleopatra
كليومينس	cleomenes
كمارا	kamara
كماك	kmoch
كماليش	kamalesh
كمبا	kemba
كمونة	kamouna
كميخ	kmeikh
كميكو	kumiko
كنانة	nadr
كندال	kendall
كندرو	kendrew
كنزة	kenza
كنساكو	kensaku
كنغليك	kinglake
كنفاني	kanafani
كنكوني	kankoune
كنوت	knut
كنيبر	knipper
كوادرادو	cuadrado
كوادو	kwadwo
كوارتي	quartey
كوازيمودو	quasimodo
كواشيما	kawashima
كوالي	qualley
كوالين	qualen
كوامي	kwame
كوانتيز	quantez
كواندا	coanda
كوانغ	kwang
كواوتيموك	cuauhtemoc
كوايسون	quaison
كوباسيك	kubasek
كوبالا	kubala
كوباياشي	kobayashi
كوباين	cobain
كوبرفيلد	copperfield
كوبريك	kubrick
كوبزيك	kubizek
كوبكا	kupka
كوبكه	kopke
كوبلاند	copeland
كوبلر	kubler
كوبلي	copley
كوبمان	koopman
كوبو	kubo
كوبورن	coburn
كوبوس	cobos
كوبوشي	kobushi
كوبولد	cobbold
كوبياتشفيلي	kobiashvili
كوبيتسا	kubica
كوبيرو	cubero
كوبيسويز	kupcewicz
كوتارجي	kutaragi
كوتريكاساس	cuatrecasas
كوتزر	coetzer
كوتزيبو	kotzebue
كوتشاريان	kocharyan
كوتشاك	kouchak
كوتشان	kucan
كوتشيس	kocsis
كوتلر	kotler
كوتورماني	kotormany
كوتوزوف	kutuzov
كوتوكو	kotoku
كوتون	cotton
كوتي	coty
كوتيلنيكوف	kotelnikov
كوثري	kosari
كوجان	coogan
كوجك	kuchik
كوجون	kojun
كوجيما	kojima
كوخ	koch
كوخلر	kuchler
كوداس	koudas
كودالي	kodaly
كوداما	kodama
كودجو	kodjoe
كودر	couder
كودرو	kudrow
كودرون	caudron
كودريا	codrea
كودرينغتون	codrington
كودلين	cudlin
كودي	cody
كوديسال	codesal
كودينا	codina
كورادو	corrado
كورادي	corradi
كوراديني	corradini
كورازون	corazon
كوراس	coras
كورافليوف	kuravlyov
كوراكي	kuraki
كورال	corral
كوراليس	corrales
كوران	curran
كوراي	koray
كورايما	coraima
كورب	korb
كورباتشو	corbacho
كوربيلو	curbelo
كورت	kurt
كورتاثر	cortazar
كورتزمان	kurtzman
كورتس	curtis
كورتني	courtney
كورتولد	courtauld
كورتولموش	kurtulmus
كورتي	corti
كورتيز	cortes
كورتين	curtin
كورتيناي	courtenay
كورجينيوفسكي	korzeniowski
كوردا	korda
كوردوبا	cordoba
كوردوفا	cordova
كورديه	corday
كورس	kors
كورسل	gursel
كورسي	corsi
كورشين	courchesne
كورفالان	corvalan
كورفالد	korvald
كورفان	quervain
كورفينوس	corvinus
كورك	cork
كوركماز	korkmaz
كوركواس	kourkouas
كوركي	kurki
كورل	corll
كورليت	corlett
كورليتو	corletto
كورنباخ	cronbach
كورنبرغ	kornberg
كورنثويت	cornthwaite
كورنفورث	cornforth
كورنوال	cornwall
كورنى	korne
كورنيت	cornette
كورنيكوفا	kournikova
كورنيل	cornell
كورنيلينكو	kornilenko
كورنيليوس	cornelius
كورنيه	cornet
كورنييف	korneyev
كوروساوا	kurosawa
كورولنكوف	korolenkov
كوروليوف	korolev
كوروما	koroma
كورونادو	coronado
كوريتا	coretta
كوريش	koresh
كوريغالزو	kurigalzu
كوريغان	corrigan
كوريكيو	korekiyo
كوريل	curiel
كوريلنكو	kurylenko
كوريما	kuremaa
كوريه	korei
كوزكين	kuzkin
كوزلوف	kozlov
كوزن	kosen
كوزنتس	kuznets
كوزنيتسوف	kuznetsov
كوزول	kozol
كوزوي	kozue
كوزينسكي	kosinski
كوساتسو	kusatsu
كوسارين	kosarin
كوساكي	kosaki
كوسبي	cosby
كوستا	costa
كوستابايل	costabile
كوستاس	kostas
كوستاكورتا	costacurta
كوستالس	costales
كوستر	coster
كوسترس	custers
كوستلر	koestler
كوستن	costin
كوستنر	costner
كوستوديو	custodio
كوستيتش	kostic
كوستيل	costil
كوستيلو	costello
كوسرت	kosrat
كوسكي	kosuke
كوسل	kossel
كوسم	kosem
كوسوكي	kosuke
كوسيغين	kosygin
كوسيم	koussim
كوسينسكي	kocinski
كوسيوسكو	kosciuszko
كوشكان	kuskan
كوشنار	kouchner
كوشو	kosho
كوشيتكوف	kochetkov
كوشيلني	koscielny
كوشيليف	koshelev
كوغا	koga
كوغين	kogen
كوغيوكو	kogyoku
كوفال	koval
كوفر	kuffer
كوفرمانس	koevermans
كوفمان	kaufman
كوفور	kufuor
كوفين	coffin
كوفينزانيه	quvenzhane
كوكا	kuka
كوكاكو	kokaku
كوكبورن	cockburn
كوكران	cochrane
كوكروفت	cockcroft
كوكسون	cookson
كوكور	cukor
كوكورو	kokoro
كوكوسكا	kokoszka
كوكيتي	keketi
كوكيزا	kokeza
كولاتز	collatz
كولاجين	kulagin
كولاس	collas
كولاكوفا	kulakova
كولايس	coulais
كولب	kolb
كولبة	kolbe
كولبرغ	kohlberg
كولبي	colby
كولبير	colbert
كولت	colt
كولتر	coulter
كولترين	coltrane
كولتهارد	coulthard
كولتورتي	coltorti
كولجاكا	koljaka
كولدفاي	koldewey
كولر	kohler
كولسا	colsa
كولسون	culson
كولفر	colfer
كولفير	culver
كولفين	colvin
كولكين	culkin
كولكينز	caulkins
كولم	colm
كولمان	coleman
كولن	colin
كولن	collin
كولناجو	colnago
كولنيت	colnett
كولهان	culhane
كولهوف	kollhoff
كولودين	kolodin
كولوكولتسيف	kolokoltsev
كولومبو	colombo
كولومبوس	columbus
كولونيل	colonel
كولي	cooley
كوليبالي	coulibaly
كوليبايف	kulibayev
كوليبراس	culebras
كوليتز	kaulitz
كوليسون	collison
كوليغ	kulig
كوماتش	komac
كومار	kumar
كوماس	koumas
كومب	combes
كومباريه	kombouare
كومباني	kompany
كومبانيوني	compagnoni
كومباوري	compaore
كومنينوس	komnenos
كومورو	komuro
كوميه	komei
كوميو	komyo
كوناتي	konate
كونان	conan
كونتادور	contador
كونتاربيو	contarbio
كونتريراس	contreras
كونتز	koontz
كونتزه	kuntze
كونتس	kuntz
كونتشر	kuntscher
كونتشيتا	conchita
كونتي	conti
كونتيسة	countess
كونتينتو	contento
كونتيني	contini
كونج	kung
كوندان	kundan
كوندرا	kundra
كوندراتييف	kondratiev
كوندو	kondo
كوندوبيا	kondogbia
كوندون	condon
كونديرا	kundera
كونديل	condell
كونرات	conrat
كونران	conran
كونرت	kunert
كونري	connery
كونستابل	constable
كونستانت	constant
كونستانتين	constantin
كونستانتينسكو	constantinescu
كونستانتينو	constantino
كونستانتينوس	konstantinos
كونستانزو	constanzo
كونستانس	constance
كونسيلي	consigli
كونشيسكي	konchesky
كونغري	congre
كونفورت	conforti
كونلي	conley
كونواي	conway
كونور	connor
كونولي	connolly
كونومي	konomi
كونيا	cunha
كونيتسين	kunitsyn
كونيج	konig
كونيزكو	konietzko
كونيشي	konishi
كونيميتسو	kunimitsu
كونيه	kone
كوه	kuh
كوهان	cohan
كوهلمان	kuhlmann
كوهن	kuhn
كوهين	cohen
كوهيني	cohene
كوو	koo
كوون	kwon
كوياتكووسكي	kwiatkowski
كوياما	koyama
كويانتس	collantes
كويبرس	kuipers
كويرتن	kuerten
كويسادا	quesada
كويست	quest
كويستا	cuesta
كويسنيل	quesnel
كويشنير	koechner
كويفاس	cuevas
كويكي	koike
كويلهو	coelho
كويلي	kweli
كوينا	koena
كوينتانا	quintana
كوينتراو	coentrao
كوينترو	quintero
كوينتو	quinto
كوينتيروس	quinteros
كوينلان	quinlan
كوينوس	coenus
كويني	queeny
كويوت	coyote
كى	kei
كياران	ciaran
كيان	qian
كيبروب	kiprop
كيبكيتير	kipketer
كيبلر	kepler
كيبي	kebe
كيتا	keita
كيتاجيما	kitajima
كيتاسي	kitase
كيتانو	kitano
كيتاي	keitai
كيترلي	ketterle
كيتس	keats
كيتسون	kitson
كيتشيرو	keiichiro
كيتكيوفومفون	ketkeophomphone
كيتليى	keightley
كيتو	kito
كيتوكو	kitoko
كيتون	keaton
كيث	keith
كيجي	keiji
كيخسرو	kaykhusraw
كيدا	kida
كيدمان	kidman
كيدنيوس	chydenius
كيديابا	kidiaba
كيديس	kiedis
كير	kerr
كيرا	kira
كيراستاس	kyrastas
كيراونوس	keraunos
كيربي	kirby
كيرست	kerst
كيرسليك	kerslake
كيرسي	kersee
كيرشن	kirchen
كيرشنير	kirchner
كيرشو	kershaw
كيرغيوس	kyrgios
كيركغور	kierkegaard
كيركلاند	kirkland
كيركمان	kirkman
كيرل	curl
كيرن	kern
كيرني	cerny
كيروز	kayrouz
كيرون	kieron
كيري	kerry
كيرياكوس	kyriakos
كيريف	kirev
كيريلينكو	kirilenko
كيريموتو	kirimoto
كيرينسكي	kerensky
كيزار	cisar
كيززلر	czeizler
كيزل	cazale
كيزينغر	kiesinger
كيسادا	quezada
كيسار	kessar
كيساريف	kesarev
كيسايتشي	kisaichi
كيست	kist
كيسلوتي	caselotti
كيسما	cisma
كيسنوربو	kisnorbo
كيسوكه	keisuke
كيسوم	keesom
كيسي	casey
كيشور	kishore
كيشي	kishi
كيشيدا	kishida
كيشيموتو	kishimoto
كيشيو	kishio
كيغان	keegan
كيفت	kieft
كيفر	kiefer
كيفوس	kiwus
كيفين	kevin
كيقباد	kayqubad
كيككو	kikuko
كيكو	keiko
كيكوتشي	kikuchi
كيكولة	kekule
كيلافا	kelava
كيلاني	keilany
كيلبن	kilpin
كيلر	keller
كيلسو	kelso
كيلسي	kelsey
كيلغالون	kilgallon
كيلليني	chiellini
كيلن	killen
كيلهولز	kielholz
كيلونيز	cilloniz
كيلي	kelly
كيليطو	kilito
كيم	kim
كيمارايس	guimaraes
كيماكوجلو	kaimakoglou
كيمبر	kemper
كيمبرلي	kimberly
كيمبس	kempes
كيمبل	kimball
كيمرا	kimura
كيملر	kemmler
كيمواكي	kimwaki
كيموكو	kemoko
كيمونز	kemmons
كيمي	kinmei
كين	ken
كينا	cinna
كيناي	quesnay
كينت	kent
كينتارو	kentaro
كينتاوت	contout
كينجما	kingma
كينجي	kenji
كينجيتسو	kingetsu
كيند	kind
كيندريك	kendrick
كينر	keener
كينزو	kenzo
كينسكي	krinsky
كينسي	kinsey
كينغ	king
كينغستون	kingston
كينغسلي	kingsley
كينغسون	kingson
كينغو	kengo
كينكل	kinkel
كينكيلا	kinkela
كينلي	kinley
كينمان	kinnaman
كينواين	kenwyne
كينوك	kinnock
كينون	kenyon
كينونن	kinnunen
كيني	kenny
كينيتشي	kenichi
كينيث	kenneth
كينيدي	kennedy
كيوساكى	kiyosaki
كيوكاوا	kiyokawa
كيونجونغ	kyoungjong
كيير	kjær
كييوتاكه	kiyotake
لؤلؤ	lu'lu'
لا	la
لاباديا	labbadia
لابوشنيانو	lapusneanu
لابوف	labov
لابوينت	lapointe
لابيبي	lapebie
لابيترا	lapetra
لابينتي	lapentti
لابيه	labe
لابيير	lapeyre
لاتابي	latapy
لاتزا	latza
لاتشفورد	latchford
لاتشي	lachey
لاتونجي	latoundji
لاجرافينيز	lagravenese
لاجوس	lajos
لاحبي	lahbi
لادان	ladan
لادن	laden
لادوفيسكي	ladovsky
لاديسلاف	ladislav
لاذام	latham
لارا	lara
لارالدي	larralde
لارتورسيف	alatortsev
لارريا	larrea
لارسن	larsen
لارسون	larsson
لارشيه	larcher
لاركن	larkin
لارنيل	larnell
لاري	larry
لاريا	laryea
لاريجاني	larijani
لاريسا	larissa
لارين	l'wren
لاريوس	larios
لاريوندا	larrionda
لازارو	lazaro
لازاروس	lazarus
لازاري	lazzari
لازاريديس	lazaridis
لازينبي	lazenby
لاسال	lassalle
لاسانا	lassana
لاسر	lasser
لاسكر	lasker
لاسلاند	laslandes
لاسو	laso
لاسويل	lasswell
لاسي	lasse
لاسيتر	lasseter
لاسيل	lassell
لاسينا	lassina
لاغارد	lagarde
لاغرانج	lagrange
لاغرباك	lagerback
لاغرلوف	lagerlof
لاغوارديا	laguardia
لاغوس	lagos
لاغونا	laguna
لافا	lava
لافاتا	lafata
لافال	laval
لافالي	lavalle
لافتهوس	lofthouse
لافر	laffer
لافرتي	lafferty
لافروف	lavrov
لافرونينكو	lavronenko
لافلور	lafleur
لافوريت	laforet
لافون	lavon
لافيتشيا	lavecchia
لافيجري	lavigerie
لافيرتي	laverty
لافيلا	lavilla
لافينيا	lavinia
لاقو	lagu
لاكارن	lacarne
لاكامب	lacamp
لاكايه	lacalle
لاكروتل	lacretelle
لاكروز	lacruz
لاكورت	lacourt
لاكويستا	lacuesta
لال	lal
لالا	lala
لامار	lamar
لامارتين	lamartine
لامارك	lamarck
لاماركا	lamarca
لاماه	lamah
لامب	lamb
لامبارد	lampard
لامبايرتس	lombaerts
لامبورت	lamport
لامبورد	lambourde
لامرز	lammers
لامور	lamour
لاميا	lamia
لاميتا	lamitta
لاميدي	lamidi
لانارد	lanard
لانتر	lanter
لانتوس	lantos
لانجان	langan
لانجفان	langevin
لانجهام	langham
لاندابورو	landaburu
لاندروت	landrut
لاندرين	landrin
لاندشتاينر	landsteiner
لاندغراف	landgrave
لاندميسر	landmesser
لاندولف	landulf
لاندون	landon
لانزا	lanza
لانزافامي	lanzafame
لانزي	lanzi
لانس	lance
لانسبوري	lansbury
لانسراي	lanceray
لانسي	lancie
لانسينغ	lansing
لانغ	lang
لانغر	langer
لانغستون	langston
لانغل	l'engle
لانغهانز	langhans
لانغوريا	longoria
لانغيراك	langerak
لانغيلا	langella
لانغيلر	langiller
لانغيندال	lagendaal
لانغينوس	langenus
لانكاستر	lancaster
لانكير	lancker
لانوس	lanus
لانوي	lannoy
لانيلا	iannella
لاو	lau
لاوتربر	lauterbur
لاوتون	lawton
لاودا	lauda
لاودروب	laudrup
لاورسن	laursen
لاوري	lauri
لاوريدسن	lauridsen
لاوندز	lowndes
لاوي	laue
لايتبادى	lightbody
لايتفوت	lightfoot
لايتنر	leitner
لايتون	leighton
لايز	leys
لايستاديوس	laestadius
لايستنر	laistner
لايغل	laigle
لايل	lyell
لايلوس	laelius
لاين	lane
لايون	layun
لبكي	labaki
لبنى	lubna
لبيب	labib
لبيد	lapid
لبيض	labyad
لتسينغي	litsingi
لجاكوفا	ljalkova
لجند	legend
لحبابي	lahbabi
لحد	lahad
لحسن	lahcen
لحود	lahoud
لديبور	ledebour
لربي	lerby
لز	luz
لس	les
لسبس	lesseps
لستغ	lustig
لسكوف	liskov
لطوف	latuff
لعربي	larbi
لعنيكري	laanigri
لعيادة	layada
لفيفر	lefevre
لقمان	luqman
لكحل	lakhal
لكسنبرغ	luxenberg
لمجرد	lamjarred
لمريس	lamriss
لموشي	lamouchi
لموشية	lemmouchia
لمى	lama
لنت	lent
لنتون	linton
لنجلن	lenglen
لنجنهوف	langenhove
لندبرغ	lindbergh
لندرس	londres
لندن	london
لنكز	lings
لهتوماكي	lehtomaki
لهيب	laheeb
لو	lu
لوان	luan
لوب	loeb
لوباتشيفسكي	lobachevsky
لوباتيلي	lupatelli
لوبران	lebrun
لوبلاتونييه	l'eplattenier
لوبيتز	lubitz
لوبيز	lopez
لوبيس	lopes
لوبيغ	lebesgue
لوبينو	lupino
لوتا	lota
لوتارو	lautaro
لوتر	luther
لوتز	lotz
لوتساتي	luzzatti
لوتشر	loetscher
لوتشيان	lucian
لوتشينو	luchino
لوتشيني	lucchini
لوتنر	lautner
لوتولي	lutuli
لوتيانز	lutyens
لوتيرير	lotterer
لوتيس	loties
لوتينبيرجير	luttenberger
لوثار	lothar
لوثه	luthe
لوثير	lothair
لوجاو	logau
لوجر	lueger
لوجونس	lugones
لود	laud
لودج	lodge
لودر	lauder
لودميلا	lyudmila
لودويج	ludwig
لوديتي	lodetti
لوديرو	lodeiro
لودينجتون	luddington
لوديو	ledoux
لورا	laura
لوران	laurent
لورانا	laurana
لوركا	lorca
لورمان	luhrmann
لورنتز	lorenz
لورنز	laurens
لورنزيتي	lorenzetti
لوريا	luria
لوريتيلو	loritello
لوريرو	loureiro
لوريمر	lorimer
لورين	lauren
لورين	lorraine
لورينتي	llorente
لورينزو	lorenzo
لورينزي	lorenzi
لورينو	laureano
لوزي	luzi
لوستينبيرغر	lustenberger
لوسنيلدي	lucenilde
لوسي	lucy
لوسيا	lucia
لوسيان	lucien
لوسيانو	luciano
لوشان	lushan
لوغ	logue
لوغان	logan
لوغانو	lugano
لوغانيس	louganis
لوغتون	loughton
لوغلين	loughlin
لوغو	lugo
لوغوفيت	logofet
لوفاتي	lovati
لوفت	luft
لوفرانكو	lofranco
لوفرتور	louverture
لوفرين	lovren
لوفلر	loffler
لوفيت	lovett
لوفيفر	lefebvre
لوفيل	lovell
لوفيلس	loveless
لوفين	lofven
لوك	luke
لوكا	luca
لوكاتش	lukac
لوكاريلي	lucarelli
لوكاس	lucas
لوكاشينكو	lukashenko
لوكتي	lochte
لوكريسيا	lucrezia
لوكزاك	luczak
لوكسان	luccin
لوكسمبورغ	luxemburg
لوكلرك	leclerc
لوكلير	locklear
لوكو	loko
لولو	lolo
لوليس	lawless
لومارشال	lemarchal
لوماس	lomas
لومبارت	llompart
لومبارد	lombard
لومبرانا	lombrana
لومبروزو	lombroso
لومسدن	lumsden
لوموند	lemond
لومونوسوف	lomonosov
لوميت	lumet
لونا	luna
لونارديني	lunardini
لونجيوس	longus
لوند	lundh
لوندال	lundahl
لوندبيرغ	lundberg
لوندغرين	lundgren
لوندي	lundy
لونرمان	lenormant
لونسديل	lonsdale
لونغ	long
لونغشامب	longchamp
لونغي	longhi
لونكريك	longrigg
لوني	launay
لونيل	lunel
لوهان	lohan
لوهمان	lohman
لوو	lowe
لوول	luol
لويت	levitt
لويد	lloyd
لويسا	luisa
لويل	lowell
لويناس	loynaz
لوينثال	lowenthal
لوينسكي	lewinsky
لى	li
لي	lee
ليارد	laird
لياركو	learco
لياقت	liaquat
ليام	liam
لياندرو	leandro
ليانغ	liang
ليب	leeb
ليبار	libar
ليبرتي	liberty
ليبرمان	lieberman
ليبرون	lebron
ليبريت	liebrecht
ليبست	lipset
ليبسكند	libeskind
ليبشيتز	lipchitz
ليبور	libor
ليبويوف	leboeuf
ليبي	libby
ليبيتسكايا	lipnitskaya
ليبيد	lebed
ليبيراتي	liberati
ليبين	lepine
ليبينسكي	lipinski
ليتبارسكي	littbarski
ليترمان	letterman
ليتريل	littrell
ليتريم	leterme
ليتسون	letson
ليتش	leach
ليتشاي	lichaj
ليتشمان	leachman
ليتشي	litschi
ليتغيب	leitgeb
ليتفينوف	litvinov
ليتورنيو	letourneau
ليتي	leite
ليتيزي	letizi
ليتيزيا	letizia
ليتيليير	letelier
ليث	laith
ليثاون	lezaun
ليثغو	lithgow
ليجا	lega
ليجروس	legros
ليجويزامو	leguizamo
ليجي	leiji
ليخاريتا	lejarreta
ليخت	licht
ليدا	lida
ليدجر	ledger
ليدربرغ	lederberg
ليدل	liddell
ليدلي	ledley
ليدن	leyden
ليدهام	leedham
ليدهولم	liedholm
ليدي	lady
ليديا	lydia
ليدينت	ledent
ليرنير	lerner
ليرو	leroux
ليروي	leroy
ليري	leary
ليزا	lisa
ليزل	liezel
ليزني	lesnie
ليزيل	leisel
ليستراد	lestrade
ليستون	liston
ليستين	lestienne
ليسلي	leslie
ليسي	lacey
ليسيتزا	lisitsa
ليسيتزكي	lissitzky
ليسيج	lessig
ليسير	leysser
ليسين	lisin
ليسينغ	lessing
ليسينكو	lysenko
ليشتنبرجر	lichtenberger
ليشتنشتاين	lichtenstein
ليغروتالي	legrottaglie
ليغفينسكي	legwinski
ليغيزامون	leguizamon
ليفا	leiva
ليفان	levan
ليفاندوفسكي	lewandowski
ليفانوف	livanov
ليفربول	liverpool
ليفسون	leveson
ليفكوويتز	lefkowitz
ليفلي	lively
ليفنسون	levinson
ليفونيفسكي	levaneuski
ليفي	levy
ليفيا	livia
ليفيتزكي	levitzky
ليفيراني	liverani
ليفيل	ifil
ليفيلد	layfield
ليفيلس	levels
ليفيمير	leipheimer
ليفيناس	levinas
ليفيوس	livius
ليك	lake
ليكا	leca
ليكابينا	lekapene
ليكونا	lecuona
ليلا	lella
ليلوي	lilloe
ليليا	lilia
ليليان	lilian
ليلييبيورن	liljebjorn
ليم	lim
ليما	lima
ليماري	lymari
ليماسون	lemasson
ليمانيس	lemanis
ليمبروك	lehmbruck
ليمبيرسكي	limbersky
ليمبيرغ	limberg
ليمبيكا	lempicka
ليمون	lemmon
ليناريس	linares
لينانكوسكي	linnankoski
لينتز	lentz
لينتس	lenz
لينتيني	lentini
ليند	lind
ليندا	linda
ليندر	linder
ليندروث	linderoth
ليندساي	lindsey
ليندسي	lindsay
ليندفاي	lendvai
ليندفيلد	lindfield
ليندل	lendl
ليندن	linden
لينر	lehner
لينس	llense
لينسيوني	lencioni
لينش	lynch
لينغ	ling
لينغارد	lingard
لينغزان	lingzan
لينغل	lingle
لينفوت	linfoot
لينك	link
لينكس	lennox
لينكليتر	linklater
لينكولا	linkola
لينكي	lencie
لينلد	leland
لينلي	linley
لينو	leno
لينوس	linus
لينون	lennon
ليني	lenny
ليهار	lehar
ليهاي	leahy
ليهمر	lehmer
ليو	leo
ليوباردو	leobardo
ليوباردي	leopardi
ليوبوف	lyubov
ليوبولد	leopold
ليوبولدو	leopoldo
ليوبومير	ljubomir
ليوبيشا	ljubisa
ليوبييانكيتش	ljubijankic
ليوتا	liotta
ليوتار	lyotard
ليوسر	loesser
ليوغويون	leugueun
ليون،	lyon
ليونا	leona
ليونارد	leonard
ليونتاين	leontyne
ليونتيف	leontiev
ليونز	lions
ليونوف	leonov
ليوني	leoni
ليونيد	leonid
ليونيدوفيش	leonidovich
ليونيل	lionel
ليويس	lewis
ليويكا	lewycka
لیلى	leila
مؤدب	moadab
مؤمن	moamen
ما	ma
مائير	meir
مابلي	mably
مابيدي	mabedi
ماتا	mata
ماتابوينا	matabuena
ماتارازو	matarazzo
ماتاريلا	mattarella
ماتر	mater
ماترلينك	maeterlinck
ماتسكازي	matsukaze
ماتسموتو	matsumoto
ماتسوؤو	matsuo
ماتسودا	matsuda
ماتسورا	matsuura
ماتسوزاكي	matsuzaki
ماتسوزاوا	matsuzawa
ماتسوشيتا	matsushita
ماتسوكا	matsuoka
ماتسوكاتا	matsukata
ماتسوكاس	matsoukas
ماتسولا	mazzola
ماتسياما	matsuyama
ماتشادو	machado
ماتشلاس	machlas
ماتشينو	maschinot
ماتفيينكو	matviyenko
ماتكوفسكي	matkowski
ماتلابا	matlaba
ماتلر	mattler
ماتوتشيك	matuszczyk
ماتورانا	maturana
ماتوس	mattus
ماتوفينوفيتش	matovinovic
ماتوكس	mattocks
ماتومونا	matumona
ماتويدي	matuidi
ماتي	matti
ماتيا	mattia
ماتياس	matthias
ماتيب	matip
ماتيتش	matic
ماتيراتزي	materazzi
ماتيسون	matthisson
ماتيسين	mathijsen
ماتيلدا	matilda
ماتينجلي	mattingly
ماتيو	matteo
ماتيوني	mattioni
ماتييه	matthiae
ماثو	matthau
ماثوهو	mathoho
ماثيسون	matheson
ماثيو	matthew
ماثيوز	mathews
ماثيوس	matthews
ماجر	madjer
ماجفود	majfud
ماجلان	magellan
ماجوريل	majorelle
ماخ	mach
ماخت	macht
مادرنو	maderno
مادس	mads
مادلونغ	madlung
مادلين	madeleine
مادن	madden
مادورو	maduro
مادوف	madoff
مادونا	madonna
مادي	maddie
ماديرا	madera
ماديلونغ	madelung
مارا	mara
مارات	marat
مارازينا	marazzina
ماراس	maras
ماراش	marach
مارانغ	marange
مارانيون	maranon
مارتا	marta
مارتر	martyr
مارتشال	marchal
مارتشينا	marchena
مارتشيني	marchini
مارتشيورو	marchioro
مارتن	martin
مارتنيه	martinet
مارتيل	martel
مارتينا	martina
مارتينز	martins
مارتينو	martino
مارتيني	martini
مارتينيز	martinez
مارتينيلي	martinelli
مارث	marth
مارثا	martha
مارثيلا	marcela
مارجاريته	margarete
مارجريتا	margarita
مارجوت	margot
ماردي	mardy
مارسترز	marsters
مارستون	marston
مارسدن	marsden
مارسوفسزكي	marsovszky
مارسيانو	marciano
مارسيل	marcel
مارسيلو	marcelo
مارسيلينوس	marcellinus
مارسيليوس	marcellus
مارسين	marcin
مارشال	marshall
مارشنتي	marchante
مارغيريتا	margherita
مارفا	marva
مارفو	marveaux
مارفيك	marwijk
مارفين	marvin
ماركس	marks
ماركس	marx
ماركهام	markham
ماركوتا	markota
ماركوزه	marcuse
ماركوس	marcus
ماركوف	markov
ماركوفيتش	markovic
ماركوليتا	marculeta
ماركوليني	marcolini
ماركوني	marconi
ماركويتز	markowitz
ماركويتي	marquette
ماركيان	markian
ماركيتي	marchetti
ماركيث	marquez
ماركيرت	markert
ماركيزيو	marchisio
ماركيولا	markkula
ماركيوني	marchionni
مارلون	marlon
مارلي	marley
مارليت	marlet
مارلين	marilyn
مارلينه	marlene
مارلينيس	marlenis
مارمول	marmol
مارمون	marmont
مارو	marot
ماروك	maroc
مارون	maroun
ماروه	maroh
ماري	mary
ماريا	maria
مارياس	marias
ماريان	marian
ماريانا	mariana
ماريانوفيتش	marjanovic
ماريبوي	maryboy
ماريتش	maric
ماريجيلا	marighella
ماريرو	marrero
ماريز	marais
ماريسكا	maresca
ماريفو	marivaux
ماريك	marek
مارينا	marina
مارينر	mariner
مارينزيو	marenzio
مارينو	marino
مارينوس	marinus
مارينيتي	marinetti
ماريو	mario
ماريوت	mariot
ماريوتو	mariotto
ماريوري	marjorie
ماريوس	marius
ماريون	marion
مازق	maziq
مازو	maazou
مازور	mazur
مازوز	mazouz
مازيتي	mazzetti
مازينيو	mazinho
مازييلو	masiello
ماسا	massa
ماساتو	masato
ماسارو	masaru
ماساكو	masako
ماسانوري	masanori
ماساهارو	masaharu
ماساهيرو	masahiro
ماساهيكو	masahiko
ماسايا	masaya
ماسايوشي	masayoshi
ماسبولي	maspoli
ماسبيرو	maspero
ماستا	masta
ماستاني	masutani
ماسترز	masters
ماستروناردي	mastronardi
ماستين	masten
ماستينو	mastino
ماسدا	masuda
ماسكارا	mascara
ماسكاني	mascagni
ماسكري	masqueray
ماسكيروني	mascheroni
ماسكين	maskin
ماسور	masur
ماسوكا	masuoka
ماسون	mason
ماسياس	macias
ماسيتي	masetti
ماسيمو	massimo
ماسيموف	massimov
ماسين	maassen
ماسينغا	masinga
ماسينيه	massenet
ماشانغازهيكي	mushangazhike
ماشكوف	mashkov
ماشو	machaut
ماشيما	mashima
ماغات	magath
ماغالهايز	magalhaes
ماغرو	magro
ماغريت	magritte
ماغناني	magnani
ماغنو	magno
ماغنوزي	magnozzi
ماغنوس	magnus
ماغني	magne
ماغي	maggie
مافروس	mavros
مافوبا	mavuba
ماقوماييف	magomayev
ماكاتشا	makacha
ماكارثر	macarthur
ماكالوم	mccallum
ماكاليف	mckelvie
ماكايا	macaya
ماكبارتلن	mcpartlin
ماكدونا	mcdonagh
ماكدونالد	macdonald
ماكدويل	mcdowell
ماكديرميد	macdiarmid
ماكروري	mccrory
ماكريه	mccrae
ماكرييف	makriev
ماكس	max
ماكسويل	maxwell
ماكسيم	maxime
ماكغراث	mcgrath
ماكغفرن	mcgovern
ماكغلينشي	mcglinchey
ماكغينس	mcguinness
ماكفادين	macfadyen
ماكفارلن	macfarlane
ماكفيرسن	macpherson
ماكلارين	mclaren
ماكلاشلان	maclachlan
ماكلورين	maclaurin
ماكلوهان	mcluhan
ماكليلاند	mcclelland
ماكمانوس	mcmanus
ماكن	machin
ماكنامارا	mcnamara
ماكنتاير	mcintyre
ماكندر	mackinder
ماكندو	mcindoe
ماكنرو	mcenroe
ماكنزي	mackenzie
ماكنيلي	macnelly
ماكو	mako
ماكور	makor
ماكورت	mccourt
ماكورماك	mccormack
ماكوري	mccurry
ماكوفسكي	makovsky
ماكولوغ	mccullough
ماكولي	macaulay
ماكون	makoun
ماكونهي	mcconaughey
ماكونوهي	mcconnohie
ماكونيل	mcconnell
ماكويلون	maquilon
ماكيبا	makeba
ماكيبين	mackeben
ماكيد	mckidd
ماكيدا	macheda
ماكيلين	mckellen
ماكين	mccain
ماكينغا	macanga
ماكينو	makino
ماكينوا	makinwa
ماكينوك	makienok
ماكينون	mackinnon
ماكيني	mckinney
ماكيون	mckeon
مالاتيستا	malatesta
مالارميه	mallarme
مالاغو	malago
مالافيف	malafeev
مالانيما	malanima
مالتريتز	maltritz
مالتيز	maltese
مالدونادو	maldonado
مالديرا	maldera
مالديني	maldini
مالرو	malraux
مالس	malus
مالفاي	malivai
مالك	malik
مالكوفيتش	malkovich
مالكولم	malcolm
مالكيل	malkiel
مالو	malot
مالوان	mallowan
مالون	mallon
مالونغا	malonga
ماليت	mallet
ماليرب	malherbe
ماليك	malick
مالينكوف	malenkov
مامادو	mamadou
مامادي	mamady
ماموتو	mamoutou
مامي	mami
مان	mann
مانارينو	mannarino
ماناس	manas
ماناسيرو	manassero
مانتسل	manzel
مانتيجنا	mantegna
مانتيلا	mantilla
مانجاروتي	mangiarotti
مانجيلا	minghella
مانخارين	manjarin
مانداندا	mandanda
ماندجوكيتش	mandzukic
ماندفيل	mandeville
ماندلر	mandler
مانديلا	mandela
مانديلي	mandelli
مانريكي	manrique
مانزانو	manzano
مانزون	manzon
مانزوني	manzoni
مانسار	mansart
مانساري	mansare
مانسالي	mansaly
مانسفيلد	mansfield
مانسن	manson
مانسيان	mancienne
مانسيل	mansell
مانشتاين	manstein
مانشين	manchin
مانشيني	mancini
مانغا	manga
مانغولد	mangold
مانغويل	manguel
مانفريد	manfred
مانفريديني	manfredini
مانكل	mankell
مانكين	mankin
مانموهان	manmohan
مانهايم	mannheim
مانو	manu
مانوج	manoj
مانور	manor
مانولاس	manolas
مانولو	manolo
مانويل	manuel
مانويلا	manuela
مانياكيس	maniakes
مانيان	magnin
مانيتي	manetti
مانيسا	manasseh
مانيسييه	manessier
مانيل	manel
مانيلو	manilow
مانيليوس	manilius
مانينغ	manning
مانينغر	manninger
مانينن	manninen
مانينو	mannino
مانيني	mannini
ماهاليا	mahalia
ماهون	mahone
ماهينمي	mahinmi
ماو	mao
ماودومالك	maodomalick
ماورو	mauro
ماوريسيو	mauricio
ماي	may
مايا	maya
ماياكوفسكي	mayakovsky
مايباخ	maybach
مايبل	mabel
مايتي	mayte
مايثتو	maeztu
مايجاري	maigari
مايدا	maeda
مايده	meyde
ماير	meyer
مايرز	myers
مايرين	mayrin
مايستروفيتش	majstorovic
مايسنر	meissner
مايسورادز	maisuradze
مايفريدي	maifredi
مايكا	majka
مايلارت	maillart
مايلر	meyler
مايلستون	milestone
مايلي	miley
ماينارد	maynard
ماينفروي	mainfroi
ماينه	meine
ماينورينغ	mainwaring
مايه	maye
مايهارا	maehara
مايهيو	mayhew
مايو	mayo
مايوركا	majorca
مايوفسكي	majewski
مايوكا	mayuka
مايوكو	mayuko
مايولو	maiolo
مايومي	mayumi
مايويذر	mayweather
ماييرهوفر	maierhofer
مبارك	mubarak
مباكوي	mbakwe
مبانانغويي	mbanangoye
مبايام	mbaiam
مبخوت	mabkhout
مبسوط	mabsout
مبشر	mubashir
مبولا	mbola
مبوما	m'boma
مبيا	mbia
مبيسوما	mbesuma
مبينزا	mpenza
متحدة	mottahedeh
متري	mitri
متسوتاني	matsutani
متعب	mutaib
متكالف	metcalfe
متوسلیان	motevaselian
متيليغا	mtiliga
مجالبي	mjallby
مجاني	medjani
مجرشي	majrashi
مجور	mujawar
مجير	mujir
محادين	mahadin
محاميد	mahameed
محبوبة	mahbooba
محترم	muhterem
محتشم	muhtasham
محرز	mahrez
محرمة	mihrimah
محروس	mahrous
محسن	mohsen
محسني	mohseni
محسوب	mahsoub
محفوظ	mahfouz
محمدوف	mammadov
محمصاني	mahmassani
محمود	mahmoud
محند	mohand
مخلوف	makhlouf
مخملباف	makhmalbaf
مخنف	mikhnaf
مخول	makhoul
مخيون	makhioun
مدبولي	madbouly
مدرس	modarres
مدكور	madkour
مدلسي	medelci
مدني	madani
مدور	medawar
مديحة	madiha
مدين	mediene
مراز	mraz
مراش	marrash
مراغة	muragha
مرة	murrah
مرتاكيس	martakis
مرجانة	morjana
مردا	mrđa
مرداس	mirdas
مردان	merdan
مردم	mardam
مردوخ	marduk
مرزباخ	marzbach
مرسال	mersal
مرسل	mursal
مرسيدس	mercedes
مرشد	murshid
مرعشلي	meraachli
مرفاوي	marfavi
مرقدي	mraqqadi
مرقص	murkus
مرلي	merle
مرهون	marhoon
مروان	marwan
مروي	marwi
مريابا	mariappa
مرياح	meriah
مريد	mourid
مزئيل	mazel
مزالي	mzali
مزراحي	mizrahi
مساعدة	masa'deh
مسامح	musameh
مستاوي	moustaoui
مستجاب	mustagab
مسخادوف	maskhadov
مسرحي	masrahi
مسرور	masroor
مسري	msarri
مسرين	mesrine
مسلوب	mesloub
مسواتي	mswati
مسيلنيا	mcelnea
مش	mosh
مشاري	mishari
مشاعل	misha'al
مشهراوي	masharawi
مشهور	mashhur
مشود	mashood
مشيري	mecheri
مشيلح	msheleh
مصابيح	mecabih
مصباح	mesbah
مصري	masri
مصطفى	mustafa
مصطفينا	mustafina
مصفا	mosaffa
مطلك	mutlak
مطمور	matmour
مطهر	mutaher
مظهر	mazhar
معروف	maarouf
معروفي	maaroufi
معشر	ma'shar
معصوم	masum
معصومة	massouma
معلوف	maalouf
معلوم	malloum
معمار	mimar
معمري	mammeri
معن	maan
معوض	moawad
معيتيق	maiteeq
معيزة	maiza
معيوف	mayouf
مغانغيرا	mgangira
مغبغب	mghabghab
مغنية	mughniyah
مفدي	moufdi
مفويمبا	mvuemba
مقار	macarius
مقتدى	muqtada
مقداد	mekdad
مقرن	muqrin
مقصود	maksoud
مقصيد	maqseed
مكأدامز	mcadams
مكادو	mcadoo
مكارتني	mccartney
مكارثي	mccarthy
مكاروني	maccarone
مكاري	makari
مكافوي	mcavoy
مكافي	mcafee
مكالاني	mccallany
مكان	mccann
مكانداويري	mkandawire
مكاولي	mcauley
مكاي	mckay
مكبرايد	mcbride
مكتبي	maktabi
مكتوم	maktoum
مكتيرنان	mctiernan
مكجاري	mcgary
مكدوال	mcdouall
مكدونالد	mcdonald
مكديفيت	mcdevitt
مكراكين	mccracken
مكراي	mccray
مكرم	makram
مكروبيرتس	mcroberts
مكري	mokri
مكستاي	mcstay
مكسيس	mexes
مكسيم	maxim
مكسيموفتش	maximovich
مكغان	mcgann
مكغي	mcghee
مكفادين	mcfadden
مككلير	mcclair
مككمسون	mckimson
مككولوتش	mcculloch
مكلجت	mcelligott
مكلين	mclean
مكمان	mcmahon
مكناوغتون	mcnaughton
مكندلز	mccandless
مكوي	mccoy
مكيشران	mceachran
مكينزي	makenzie
مكينيز	mckenzie
مل	mill
ملادينوف	mladenov
ملادينوفيتش	mladenovic
ملادينيتش	mladinic
ملانكتون	melanchthon
ملبيغي	malpighi
ملجم	muljam
ملحو	melho
ملغرام	milgram
ملفل	melvil
ملفن	melvyn
ملفين	melvin
ملكي	maleki
ملنور	milnor
ملينديز	melendez
ممتاز	momtaz
ممدوح	mamdouh
مملوك	mamlouk
ممنون	mamnoon
مناجد	mnajed
مناحيم	menachem
مناع	mana'a
منال	manal
منبه	munabbih
منتسبرغ	mintzberg
منتوحتب	mentuhotep
منجالي	menichelli
منجونغ	munjong
مندان	mandan
مندريس	menderes
مندل	mendel
مندلييف	mendeleev
مندني	mandanipour
مندور	mandur
مندومو	enam
مندونكا	mendonca
منذر	munther
منشوف	menshov
منصر	moncer
منظور	manzur
منعم	menem
منغ	meng
منغنا	mingana
منغوميني	mngomeni
منغي	mingyi
منك	munk
منليك	menelik
منوتشهري	manutchehri
منور	munawar
منى	mona
منيرة	munira
منيلاوس	menelaus
مهاتما	mahatma
مهجع	mehjaa
مهدفيكيا	mahdavikia
مهدي	mehdi
مهرجوئي	mehrjui
مهري	mehri
مهلونغو	mhlongo
مهنا	mehanna
مهند	mohannad
مواتالي	muwatalli
موافر	moivre
موافوليروا	mwafulirwa
موافي	muwafi
موامبا	muamba
موانزا	mwanza
موباسان	maupassant
موباليط	muballit
موبرتيوس	maupertuis
موبيوس	mobius
موتا	mota
موتا	motta
موتاريلي	mutarelli
موترام	mottram
موتسارت	mozart
موتستيغ	meutstege
موتكو	mutko
موتوكو	motoko
موتوكي	motoki
موتومو	motomu
موتيس	muttis
موتينيو	moutinho
موثاريكا	mutharika
موجيريدجي	muggeridge
موجيس	mogis
موحو	mukhu
موخرجي	mukerji
مودا	moda
مودل	model
مودود	mawdud
موديستو	modesto
موديلياني	modigliani
مودينا	modena
موراتا	morata
موراتوف	muratov
موراتي	moratti
موراتين	moratin
مورازان	morazan
مورافيا	moravia
مورافيتز	moravetz
مورافيك	moravek
موراكاوا	murakawa
مورال	moral
موران	moran
موراناكا	muranaka
موراني	mourani
موراويك	murawiec
موراي	murray
موربيديلي	morbidelli
مورتالا	murtala
مورتن	morten
مورتيمير	mortimer
مورتينيو	murtinho
مورجان	morgan
مورجيا	murguia
موردوك	murdock
مورديك	mordake
مورر	maurer
مورس	morse
مورسيو	morseu
مورغادو	morgado
مورغاني	morgagni
مورغانيلا	morganella
مورغنثاو	morgenthau
موركوت	murcutt
مورلوك	morlock
مورهاوس	moorhouse
مورهايم	morhaime
موروا	mauroy
موروزيفيتش	morozevich
موروفوشي	murofushi
موروني	morrone
موريارتي	moriarty
موريانتس	morientes
موريتا	morita
موريتز	moritz
موريتوري	moriteru
موريتي	moretti
موريخون	morejon
موريرا	moreira
موريسون	morrison
موريش	moric
موريشيج	morishige
موريكاوا	morikawa
موريل	morel
موريلوس	morelos
موريلون	morelon
موريلي	morelli
موريموتو	morimoto
مورين	morin
مورينز	morenz
موريني	morini
مورينيس	morenes
مورينيغو	morinigo
مورينيو	mourinho
مورييل	muriel
موزر	moser
موزلي	moseley
موزيل	musil
موس	moss
موساشي	musashi
موساكيو	musacchio
موساندر	mosander
موست	most
موسكات	muscat
موسكالا	muscala
موسكر	musker
موسكي	muskie
موسكيرا	mosquera
موسليرا	muslera
موسه	mosse
موسوليني	mussolini
موسيس	moses
موسيلو	moussilou
موسيه	musset
موسيو	museeuw
موسيير	moussier
موشج	muschg
موشويو	moshoeu
موشيزوكي	mochizuki
موشيزيب	mushezib
موشيه	moshe
موغيريني	mogherini
موفات	moffat
موفينكل	mowinckel
موقد	moqed
موكاسي	mukasey
موكجونغ	mokjong
موكل	muwakkil
مولانا	maulana
مولانيس	molanes
مولبي	mølby
مولت	moult
مولتون	moulton
مولداجولوفا	moldagulova
مولدر	mulder
مولدنكي	moldenke
مولديرز	molders
مولر	muller
مولري	mullery
مولز	mols
مولن	mullen
مولنار	molnar
مولهيرن	mulhern
مولوتوف	molotov
مولود	mouloud
مولونغي	mouloungui
مولوني	molowny
مولي	molly
موليسا	mulisa
موليسش	mulisch
موليغان	mulligan
مولينا	molina
مولينار	moolenaar
مولينز	mullins
مولينغ	mullenweg
مولينغا	mulenga
مولينو	molineaux
مومدونا	mumadona
مومفورد	mumford
مومند	mohmand
مومنز	mommens
مومو	monmu
موموزونو	momozono
موميا	mumia
مون	moon
مونارون	munaron
موناري	munari
موناغان	monaghan
موناوازا	mwanawasa
مونتاج	montague
مونتاغو	montagu
مونتالبو	montalvo
مونتالشيني	montalcini
مونتانو	montano
مونتانيس	montanes
مونتانييه	montagnier
مونترميني	montermini
مونتسر	muntzer
مونتسيني	montseny
مونتغومري	montgomery
مونتياغودو	monteagudo
مونتيبيلوسو	montepeloso
مونتيرو	monteiro
مونتيروبيو	monterrubio
مونتيز	montez
مونتيزين	montezine
مونتيس	montes
مونتيسوري	montessori
مونتيسينوس	montesinos
مونتيفيردي	monteverdi
مونتيفيلترو	montefeltro
مونتيفيوري	montefiore
مونتيلا	montella
مونتيلونغو	montelongo
مونتين	montaigne
مونتينيغرو	montenegro
موند	mond
مونداي	munday
مونرو	monroe
مونريال	monreal
مونزينبيرغ	munzenberg
مونستودر	mansdotter
مونسل	munsell
مونش	moench
مونشهاوزن	munchhausen
مونغانغا	munganga
مونغونغو	mongongu
مونفيراتو	montferrat
مونكه	mohnke
مونكو	mongke
مونماوث	monmouth
مونو	monod
مونوا	munua
مونيا	monia
مونياو	munyao
مونيتاكا	munetaka
مونيتس	munitis
مونير	mounier
مونيو	moneo
مونيوز	munoz
مونييسا	muniesa
موهر	mohr
موور	moore
مويتشال	moeschal
موير	muir
مويساندر	moisander
مويسيس	moises
مويسيغوا	mwesigwa
مويناهان	moynahan
مويني	mweene
موينيت	mouynet
ميا	mia
مياتا	miyata
مياتزا	meazza
ميادة	mayada
ميارة	mayyara
مياشيتا	miyashita
ميامرا	miyamura
مياموتو	miyamoto
ميان	mian
مياوتشي	miyauchi
ميتاباري	mateparae
ميتر	mitter
ميترا	mitra
ميتروغلو	mitroglou
ميتس	mitts
ميتسلدر	metzelder
ميتسو	mitsuo
ميتسواكي	mitsuaki
ميتسودا	mitsuda
ميتسورو	mitsuru
ميتسيتوري	mitsuteru
ميتش	mitch
ميتشل	mitchell
ميتشوم	mitchum
ميتشيباتا	michibata
ميتشيزانه	michizane
ميتشيلي	michele
ميتغود	metgod
ميتلاند	maitland
ميتنيك	mitnick
ميتوراي	mitoraj
ميتيران	mitterrand
ميثاقيان	misaghian
ميجر	major
ميجويز	miguez
ميجي	meiji
ميجيل	miguel
ميحد	mehad
ميخائيل	mikhail
ميخيا	mejia
ميد	meade
ميدران	medran
ميدفيديف	medvedev
ميدلبرغ	middelburg
ميدلتون	middleton
ميدندورب	middendorp
ميدندورف	middendorf
ميدو	mido
ميدوريكاوا	midorikawa
ميديل	medel
مير	mir
ميراج	meraj
ميرالاس	mirallas
ميرام	meram
ميراندا	miranda
ميرت	mert
ميرتشا	mircea
ميرتون	merton
ميرتيساكر	mertesacker
ميردل	myrdal
ميرزا	mirza
ميرزاخاني	mirzakhani
ميرزوييف	mirzoyew
ميرس	meares
ميرساد	mirsad
ميرسر	mercer
ميرسون	myerson
ميرصادقي	mirsadeghi
ميرفت	mervat
ميرفندرسكي	mirfendereski
ميرفي	murphy
ميرفين	mervyn
ميركادو	mercado
ميركادير	mercader
ميركس	merckx
ميركو	mirko
ميركوري	mercury
ميرليس	mirrlees
ميرني	mirnyi
ميرونوف	mironov
ميريا	mireya
ميريام	myriam
ميريتسكوف	meretskov
ميريدا	merida
ميريس	mairesse
ميريويذر	meriwether
ميز	miz
ميزا	maesa
ميزاردونايتس	mesardonites
ميزاغ	mezague
ميزس	mises
ميزكي	mizuki
ميزني	mesny
ميسان	meyssan
ميستي	misty
ميستيريو	mysterio
ميسزولي	meszoly
ميسكيتا	mesquita
ميسل	meisl
ميسمر	mesmer
ميسيل	messel
ميشا	mischa
ميشال	michel
ميشان	mechain
ميشليه	michelet
ميشولام	meshulam
ميشيليتي	micheletti
ميشيما	mishima
ميغ	meg
ميغالوديس	megaloudis
ميغنيت	mignot
ميغورو	meguro
ميغوري	meguri
ميغومي	megumi
ميغيليث	miguelez
ميغين	megyn
ميفسود	mifsud
ميفع	mayfa'
ميك	mick
ميكا	mika
ميكاكو	mikako
ميكالي	micali
ميكامي	mikami
ميكاه	micah
ميكايل	mikael
ميكري	megri
ميكس	meeks
ميكسا	mixa
ميكلسن	mikkelsen
ميكلوش	miklos
ميكنر	mechner
ميكوي	mikoi
ميكي	mickey
ميكيتا	mikita
ميكيلين	mechelin
ميكيو	mikio
ميل	mel
ميلا	milla
ميلار	millar
ميلاند	milland
ميلانزي	milanzi
ميلانو	milano
ميلانوفيتش	milanovic
ميلاني	melanie
ميلانيا	melania
ميلانيتو	milanetto
ميلباند	miliband
ميلبورن	milburn
ميلتشور	melcior
ميلتون	milton
ميلخ	mleh
ميلدريد	mildred
ميلساب	millsap
ميلشتاين	milstein
ميلشيوت	melchiot
ميلفينا	millvina
ميلكامبس	millecamps
ميلمان	melman
ميلن	milne
ميلنر	milner
ميلو	melo
ميلوا	melua
ميلوتينوفيتش	milutinovic
ميلود	miloud
ميلوش	milos
ميلوفان	milovan
ميلوفانوفيتش	milovanovic
ميليت	millett
ميليتشيب	millichip
ميليتو	milito
ميليسا	melissa
ميليغان	milligan
ميلينا	melina
ميليونيكو	miglionico
ميمونة	maymunah
ميموني	mimouni
ميمي	mimi
ميناسه	menasse
ميناغتشي	minaguchi
ميناموتو	minamoto
مينامي	minami
مينة	amina
مينتال	mintal
مينتر	minter
مينتشوف	menchov
ميندوجني	mendogni
ميندوزا	mendoza
ميندون	mindon
مينديبورو	mendiburu
مينديرز	mijnders
مينديز	mendez
مينر	minner
مينزيس	menzies
مينساه	mensah
مينسكي	minsky
مينشن	minchin
مينشيا	minxia
مينغ	ming
مينغازيني	mingazzini
مينغر	menger
مينغيو	mingyu
مينكا	minka
مينكس	minx
ميننيرت	minnert
مينوت	minot
مينوتي	menotti
مينورس	mynors
مينورو	minoru
مينولدي	mainoldi
مينونوس	menounos
ميني	minnie
مينيانا	mignogna
مينيدو	menendo
مينيرو	minero
مينيز	menez
مينيزيس	menezes
مينيغازو	menegazzo
مينيل	mennell
مينيلي	minelli
مينينديث	menendez
مينيو	meynieu
ميهايلوفيتش	mihajlovic
ميهوب	mayhoub
ميهوبي	mihoubi
ميوجين	myojin
ميوزيال	musial
ميونغسونغ	myeongseong
ميوني	muni
ميير	meier
مييرجيفسكي	mierzejewski
ن.	n.
نا	na
نابابكين	nababkin
ناباتامي	nabatame
نابر	naber
نابليون	napoleon
نابولي	naples
نابوليتانو	napolitano
نات	nat
ناتا	natta
ناتاشا	natasha
ناتسومي	natsumi
ناتشو	nacho
ناتشي	nachi
ناتفيج	natvig
ناثان	nathan
ناثانز	nathans
ناثانيال	nathaniel
ناجدورف	najdorf
ناجي	naji
ناحوم	nahum
ناخبار	nachbar
نادال	nadal
نادر	nader
نادية	nadia
نادين	nadine
نارايان	narayan
نارايانان	narayanan
نارسيس	narcisse
نارسيسو	narciso
نارسينغ	narsingh
ناركيس	narkiss
ناريشكين	naryshkin
ناريمان	narimene
ناريندرا	narendra
نازكا	nazuka
نازليموف	nazlymov
ناساتير	nasatir
ناسازي	nasazzi
ناستاسه	nastase
ناسيف	nasief
ناسيمينتو	nascimento
ناش	nash
ناشف	nashif
ناصربال	ashurnasirpal
ناغاساكو	nagasako
ناغاساوا	nagasawa
ناغانو	nagano
ناغاي	nagai
ناغورسكي	nagorski
ناغي	nagy
نافاخاس	navajas
نافار	navarre
نافارو	navarro
نافاس	navas
نافالني	navalny
نافع	nafi
نافون	navon
نافيا	navia
نافيرو	navero
نافين	naveen
ناكا	naka
ناكابا	nakaba
ناكاجيما	nakajima
ناكازاوا	nakazawa
ناكامورا	nakamura
ناكاميكادو	nakamikado
ناكانو	nakano
ناكاهارا	nakahara
ناكاياما	nakayama
ناكر	naker
ناكوزي	nakouzi
ناليس	nahles
نام	nam
ناماث	namath
نامجو	namjoo
ناميكاوا	namikawa
ناناك	nanak
نانجو	nanjo
نانديتا	nandita
نانسي	nancy
نانشي	nanshe
نانينغا	nanninga
نانيني	nannini
ناهد	nahed
ناهويل	nahuel
ناور	naur
ناوسب	nauseb
ناوكي	naoki
ناومن	naumann
ناوي	nawi
ناي	nye
نايت	knight
نايتون	knighton
نايتينجيل	nightingale
نايجل	nigel
نايدا	nida
ناير	nair
نايسميث	naismith
نايفة	nayfeh
نايك	naik
نايكست	nyquist
نايلة	nayla
نبريخا	nebrija
نبو	nabu
نبوس	nabbous
نبي	naby
نبيرغ	nirenberg
نبيل	nabil
نبيلة	nabila
نبيه	nabih
نتالي	natalie
نتانياهو	netanyahu
نجاح	najah
نجلاء	naglaa
نجيم	njeim
نجيمي	najimy
نحاس	nahas
نحميا	nehemiah
نداو	ndao
ندجوك	ndjock
ندجينغ	n'djeng
ندلوفو	ndlovu
ندومبا	n'domba
ندونغ	ndong
ندويي	n'doye
ندياي	n'diaye
نرجس	nargis
نرس	nurse
نرفال	nerval
نزار	nizar
نزاما	nzama
نزوغبيا	n'zogbia
نزونزي	n'zonzi
نزيه	nazih
نزيهة	naziha
نسب	nassab
نسبيت	nesbitt
نستله	nestle
نسل	neslisah
نسمة	nesma
نسيبة	nusseibeh
نسيد	necid
نشيد	nasheed
نصار	nassar
نصر	nasr
نصرة	ennasra
نصري	nasri
نصوح	nasuh
نصيف	nsaief
نطل	nuttall
نظام	nizam
نظيرة	nazira
نظيف	nazif
نعومكين	naumkin
نعومي	naomi
نعيمة	naima
نغ	ng
نغامبي	ng'ambi
نغريلا	negrila
نغوتي	n'gotty
نغوغ	n'gog
نغوما	ngoma
نغويرا	ngwira
نغوين	nguyen
نفاع	nafa
نفرتاري	nefertari
نفيل	nufayl
نقاش	naqqash
نقد	nugud
نك	nick
نكاز	nekkaz
نكروما	nkrumah
نكورونزيزا	nkurunziza
نكولو	nkoulou
نكومو	nkomo
نل	neul
نمرة	namira
نمري	nimri
نمور	nemours
نهاد	nihad
نهار	nahar
نهى	nuha
نهيان	nahyan
نهير	nohair
نو	no
نواز	nawaz
نواس	nuwas
نواف	nawaf
نوال	nawal
نوبار	nubar
نوبهيكو	nobuhiko
نوبواتسو	nobuatsu
نوبوسوكه	nobusuke
نوبوكو	nobuko
نوبويوشي	nobuyoshi
نوبويوكي	nobuyuki
نوتشيرينو	nocerino
نوتون	naughton
نوتي	nottet
نوث	noth
نوجوما	nujoma
نوجيما	nojima
نوح	noah
نودل	knodel
نورا	nora
نورالدين	nureddin
نورالهي	nourollahi
نورامبوينا	norambuena
نوراني	noorani
نوراي	nuray
نوربانو	nurbanu
نوربير	norbert
نورت	norte
نورتون	norton
نورثام	northam
نورثوب	northup
نوردال	nordahl
نوردستراند	nordstrand
نوردفيك	nordvik
نورغالييف	nurgaliyev
نورما	norma
نورمان	norman
نورماندي	normandy
نورمي	nurmi
نورودوم	norodom
نوريس	norris
نوريليوس	norelius
نورينبيرغ	nurenberg
نورينون	norrington
نوريوكي	noriyuki
نورييغا	noriega
نورييف	nureyev
نوزاريه	nouzaret
نوزاوا	nozawa
نوزومي	nozomi
نوزيت	nauzet
نوسباوم	nussbaum
نوسوم	nusum
نوسيج	nossig
نوشيروان	nawshirwan
نوغلي	nogly
نوغيس	nogues
نوغينت	nugent
نوفل	nawfal
نوفوسيلوف	novoselov
نوفيتسكي	nowitzki
نوفيل	nouvel
نوكانن	nykanen
نول	knoll
نولا	nola
نولاسكو	nolasco
نولاند	nuland
نولت	nolte
نولدكه	noldeke
نولز	knowles
نومرا	nomura
نوناكا	nonaka
نونكال	nungal
نونو	nuno
نوني	nonie
نونيز	nunez
نوي	noe
نويا	noya
نويتش	neutsch
نويريه	noiret
نويز	noyes
نويزر	neuser
نويكا	noica
نويمان	neumann
نويي	nooyi
نيا	nia
نياثي	nyathi
نياركو	nyarko
نياكادجا	gnacadja
نيال	niall
نيبالي	nibali
نيبرج	nyberg
نيبور	niebuhr
نيبوس	nepos
نيبولدت	nippoldt
نيتزر	netzer
نيتشكه	nitschke
نيتشه	nietzsche
نيتو	neto
نيجارد	nygaard
نيد	ned
نيدريغ	niedrig
نيدفيد	nedved
نيدلجاكوفا	nedeljakova
نيرا	neira
نيراري	nirari
نيرز	nerz
نيرنست	nernst
نيرودا	neruda
نيريري	nyerere
نيريو	nereu
نيز	knez
نيزا	niza
نيستلروي	nistelrooy
نيستور	nestor
نيسكينز	neeskens
نيسين	nesin
نيشيزاوا	nishizawa
نيشيكادو	nishikado
نيشيكاوا	nishikawa
نيشيمورا	nishimura
نيشينو	nishino
نيغاكي	niigaki
نيغريدو	negredo
نيغرين	negrin
نيغريني	negrini
نيغورسفول	nygaardsvold
نيغيشي	negishi
نيفا	neiva
نيفالدو	nivaldo
نيفتالي	neftali
نيفلاند	nevland
نيفن	niven
نيفيت	nevitt
نيفيز	navez
نيفيس	neves
نيفيسكي	nevsky
نيكر	necker
نيكراسوف	nekrasov
نيكس	nicks
نيكلسون	nicholson
نيكوس	nikos
نيكول	nicole
نيكولاوس	nicolaus
نيكولاييف	nikolaev
نيكوليتش	nikolic
نيكولين	nikulin
نيكي	nicky
نيل	neil
نيلاتون	nelaton
نيلاسي	nyilasi
نيلتون	nilton
نيلز	niels
نيلسن	nielsen
نيلسون	nelson
نيلسي	nelisse
نيلسين	nilsen
نيلو	nilo
نيلوم	nelom
نيلي	nellie
نيمان	niemann
نيماني	nimani
نيمانيا	nemanja
نيمتسوف	nemtsov
نيموتو	nemoto
نيمولر	niemoller
نيموي	nimoy
نيميير	niemeyer
نينا	nina
نيناد	nenad
نينتوكو	nintoku
نينغ	ning
نينكو	ninko
نينكوفيتش	ninkovic
نينو	nino
نينورتا	ninurta
نينوسلاف	ninoslav
نيها	neha
نيهر	neher
نيهودا	nehoda
نيهين	nehin
نيوبولد	newbold
نيوبى	newby
نيوستادتر	neustadter
نيوكمان	newcomen
نيوكومب	newcombe
نيوكيرتشنير	neukirchner
نيولاندز	newlands
نيوم	nyom
نيومار	newmar
نيومان	newman
نيوميكر	newmaker
نيون	paengnyeon
نيونر	neuner
نيوهارت	newhart
نيوهاوس	newhouse
نيي	ney
نييتو	nieto
نييرا	neyra
نييمي	niemi
هآبالاينن	haapalainen
هآرده	haarde
ها	ha
هابر	haber
هابركورن	haberkorn
هابرماس	habermas
هابيل	habil
هاتا	hata
هاتانو	hatano
هاتزيانسيتيس	hatzianestis
هاتشيلينسا	hachilensa
هاتفيلد	hatfield
هاتوري	hattori
هاتوسيلي	hattusili
هاتوياما	hatoyama
هاتيلي	hateley
هاثاواي	hathaway
هاجي	hagi
هاجيك	hajek
هاجيمي	hajime
هاد	head
هادامار	hadamard
هادجنز	hudgens
هادر	hader
هادزيابديتش	hadziabdic
هادكس	haddix
هادلي	hadley
هادوك	haddock
هادي	hadi
هارادا	harada
هارالد	harald
هاراواي	haraway
هاربر	harper
هاربو	harpo
هارت	hart
هارتال	hartal
هارتفايلد	hartfield
هارتفيغ	hartwig
هارتلي	hartley
هارتليبن	hartleben
هارتمان	hartmann
هارتنت	hartnett
هارتنيل	hartnell
هارتو	harto
هارتوك	hartock
هارتيك	harteck
هاردن	harden
هاردنغ	harding
هاردون	hardoon
هاردويك	hardwicke
هارفارد	harvard
هارفورد	harford
هارفي	harvey
هاركر	harker
هاركلرود	harkleroad
هاركوس	harkus
هارلسون	harrelson
هارلو	harlow
هارمل	harmel
هارمن	harman
هارمون	harmon
هارنويس	harnois
هارنيك	harnik
هارنيل	harnell
هاروتشيكا	haruchika
هارولد	harold
هارومي	harumi
هاري	harry
هاريس	harris
هاريسون	harrison
هاريغان	harrigan
هاريلال	harilal
هارينج	harring
هارينغ	haring
هاريوت	harriot
هاريوود	harewood
هارييت	harriet
هازارد	hazard
هازل	hazal
هازلت	hazlitt
هازنافيسيوس	hazanavicius
هازنكليفر	hasenclever
هاستينغز	hastings
هاسكارل	hasskarl
هاسكل	haskell
هاسلبيك	hasselbeck
هاسمان	hassmann
هاسمي	hasemi
هاسيبه	hasebe
هاسيلهوف	hasselhoff
هاش	heche
هاشاي	hashai
هاشمي	hashemi
هاشميان	hashemian
هاغن	hagen
هاغينز	huggins
هافاس	havas
هافانا	havana
هافيل	havel
هافيلاند	havilland
هافينار	havenaar
هاكابي	huckabee
هاكان	hakan
هاكزل	hackzell
هاكسبي	hauksbee
هاكل	hackl
هاكلوت	hakluyt
هاكمان	hackman
هاكوسيكي	hakuseki
هاكولينن	hakulinen
هاكيت	hackett
هاكينغ	hacking
هال	hal
هالدر	halder
هالستروم	hallstrom
هالفورد	halford
هالفورسن	halvorsen
هاله	halle
هالونن	halonen
هالين	halen
هاماساكي	hamasaki
هامبتون	hampton
هامبشاير	hampshire
هامبلتون	hambleton
هامر	hammer
هامراس	hammeras
هامربرغ	hammarberg
هامرستاين	hammerstein
هامشيك	hamsik
هاملتن	hamilton
هاملستش	hamlisch
هاموند	hammond
هاميت	hammett
هاميل	hamill
هامينغ	hamming
هان	han
هانا	hannah
هانازاوا	hanazawa
هانتش	hantzsch
هاندانوفيتش	handanovic
هاندكه	handke
هاندل	handel
هاندلر	handler
هاندي	handy
هانس	hans
هانسل	hensel
هانسون	hansson
هانسي	hansi
هانك	hank
هانكل	hankel
هانكه	hanke
هانكوك	hancock
هانكوكس	hancocks
هانكينسون	hankinson
هانلي	hanley
هانم	hanimefendi
هانو	hanno
هانوتو	hanotaux
هانوفر	hanover
هانيجراف	hanegraaf
هانيسكو	hanescu
هاهنه	hahne
هاوسدورف	hausdorff
هاول	howell
هاولاند	howland
هاونسفيلد	hounsfield
هاويس	hawes
هاياتو	hayato
هاياشي	hayashi
هايامي	hayami
هايبين	haibin
هايت	hyatt
هايتر	hayter
هايتلر	heitler
هايد	hyde
هايدر	haider
هايدغر	heidegger
هايدن	hayden
هايدوك	hejduk
هايدون	haydon
هايدونغ	haidong
هايرودن	hairuddin
هايروفسكي	heyrovsky
هايز	hayes
هايزنبيرغ	heisenberg
هايسبيرت	haysbert
هايفليك	hayflick
هايل	hayel
هايلاند	hyland
هايلز	hales
هايلوود	hailwood
هايمور	highmore
هايند	hinde
هاينريش	heinrich
هاينز	heinz
هاينزه	heinze
هاينس	hannes
هاينمان	heineman
هاينماير	heinemeier
هاينه	heine
هايني	heini
هاينيكي	haneke
هايوود	haywood
هبا	hobba
هبة	heba
هبل	hubal
هتسول	hutsol
هتلر	hitler
هتون	hatoon
هدام	haddam
هداوي	hadawi
هداية	hedaya
هدسون	hudson
هدى	huda
هديجر	hediger
هذلول	hathloul
هرت	hurt
هرتزل	herzl
هرتسفلد	herzfeld
هرد	herd
هردر	herder
هردي	hardi
هرماش	hermach
هرمنغيلدو	hermenegildo
هرنان	hernan
هرندل	hurndall
هرنييتشيك	hrnjicek
هروبيش	hrubesch
هريدارسون	hreiðarsson
هريرة	hurairah
هريش	aharish
هريفيلتو	herivelto
هزازي	hazazi
هزبندز	husbands
هزونغا	hezonja
هس	hess
هستر	hester
هسن	hesse
هشام	hisham
هشهش	hash'hash
هكس	hicks
هكسلي	huxley
هل	hull
هلافسكوفا	hlavackova
هلبرن	halpern
هلسا	halasa
هلفريشت	helfrich
هلكورد	halgurd
هلوشك	hlousek
هليب	hleb
هليفي	halevi
همايون	homayoon
همبرغر	hamburger
همست	himst
همسلي	hemsley
همسون	hamsun
همفري	humphrey
هميمزا	hmimssa
همينغوي	hemingway
هنبين	hennepin
هنت	hunt
هنتر	hunter
هنتلي	huntley
هنتنجتون	huntington
هنجرلي	hangerli
هند	hind
هندرسون	henderson
هندريك	hendrik
هندريكس	hendricks
هندس	hinds
هندي	hindi
هنري	henry
هنريتا	henrietta
هنريك	henrik
هنريكسن	henriksen
هنريوت	henriot
هنزل	henselmann
هنسينغ	hensing
هنغر	henger
هنلي	henle
هنن	hennen
هنية	haniyeh
هنيدي	henedi
هوا	hwa
هوار	hawar
هوارو	hoarau
هوان	hwan
هوانغ	huang
هوبارد	hubbard
هوبتشمان	hubschman
هوبز	hobbs
هوبسباوم	hobsbawm
هوبكروفت	hopcroft
هوبكنز	hopkins
هوبنيك	hubnik
هوبهاوس	hobhouse
هوبيرت	hubert
هوبيس	hobais
هوتارو	hotaru
هوتانن	huhtanen
هوتز	hotz
هوتزيندروف	hotzendorf
هوتشيسون	hutchison
هوتيكه	hottecke
هوثورن	hawthorne
هوجرت	hogarth
هوخستراسر	hochstrasser
هوخشورنر	hochschorner
هوخل	huchel
هودجسون	hodgson
هودجكن	hodgkin
هودل	hoddle
هودلر	hodler
هودلستون	huddlestone
هوراس	horace
هوراسيو	horacio
هوراشيو	horatio
هورتا	horta
هورتادو	hurtado
هورتون	horton
هورتي	horthy
هورسفال	horsfall
هورسلي	horsley
هورسيي	horsey
هورش	horch
هورفورد	horford
هوركهايمر	horkheimer
هورماندر	hormander
هورميغا	hormiga
هورن	horne
هورنا	horna
هورنبي	hornby
هورنسبي	hornsby
هورنو	horno
هوري	hori
هوريك	horik
هوريكوشي	horikoshi
هوريكيتا	horikita
هوريلهو	heurelho
هوريه	horie
هوس	hus
هوساوي	hawsawi
هوستر	huster
هوسر	hauser
هوسكينز	hoskins
هوسل	husserl
هوسوغاي	hosogai
هوسيكليب	huseklepp
هوشيد	hoshide
هوشينو	hoshino
هوغ	hogg
هوغان	hogan
هوغرت	hoggart
هوغل	huggel
هوغلاند	hoogland
هوغنكامب	hovenkamp
هوغنن	hugunin
هوغو	hugo
هوف	hoff
هوفا	hoffa
هوفستاتر	hofstadter
هوفشميد	hufschmid
هوفمان	hofmann
هوفمانستال	hofmannsthal
هوفمانسفالداو	hoffmannswaldau
هوفيل	hovell
هوك	hook
هوكر	hooker
هوكني	hockney
هوكينز	hawkins
هوكينغ	hocking
هول	hall
هولاكو	hulagu
هولاند	holland
هولاندر	hollander
هولاين	hollein
هولباخ	d'holbach
هولت	holt
هولتبي	holtby
هولدبروكس	holdbrooks
هولدر	holder
هولدرلين	holderlin
هولدن	holden
هولدينغ	houlding
هولزر	holzer
هولست	holst
هولسته	holste
هولستي	holsti
هولسنباين	holzenbein
هولكر	holcer
هولكينبيرغ	hulkenberg
هولليريث	hollerith
هولم	holm
هولمستروم	holmstrøm
هولمن	holmen
هولنس	holness
هولنياك	holonyak
هولواي	holloway
هولوفسنر	holofcener
هولي	holly
هوليباس	holebas
هوليداي	holiday
هوليس	hollis
هوليوك	holyoake
هومبولت	humboldt
هومبيرتو	humberto
هونا	honna
هونام	hunnam
هونبال	hunebelle
هونتيوك	hontyuk
هونجونغ	heonjong
هونيكر	honecker
هوهمان	hohmann
هوهنبيرغ	hohenberg
هوورث	howorth
هويان	huiyan
هويبرغ	højbjerg
هويدا	hoveyda
هويدونك	hooijdonk
هويدونككس	hoydonckx
هويزنجا	huizinga
هويس	heuss
هويفان	hoeven
هويل	hoyle
هويون	huewen
هيا	haya
هيالي	healey
هيامس	hyams
هيبرانكو	hebranko
هيبرت	hibbert
هيبورن	hepburn
هيبوليتو	hipolito
هيبيا	hyypia
هيتزلسبيرغر	hitzlsperger
هيتشكوك	hitchcock
هيتشنز	hitchens
هيتفيلد	hetfield
هيتوشي	hitoshi
هيتومي	hitomi
هيتون	heaton
هيتى	hetty
هيتينغا	heitinga
هيث	heath
هيثر	heather
هيثكوت	heathcote
هيثم	haitham
هيجونغ	hyejong
هيجيتا	higuita
هيداكا	hidaka
هيدالغو	hidalgo
هيدفيلد	heidfeld
هيدل	heddle
هيدليستون	hiddleston
هيدمان	hedman
هيدن	hiden
هيدي	headey
هيدياكي	hideaki
هيديتادا	hidetada
هيديتو	hideto
هيديتوشي	hidetoshi
هيديكي	hideki
هيديو	hideo
هيديوكي	hideyuki
هيراتا	hirata
هيراكاوا	hirakawa
هيراماتسو	hiramatsu
هيرانو	hirano
هيراي	hirai
هيربان	herbin
هيربر	herber
هيرتر	herter
هيرتزبرغر	hertzberger
هيرتس	hertz
هيرتسوغ	herzog
هيرتلنغ	hertling
هيردا	herda
هيرزن	herzen
هيرست	hirst
هيرش	hirsch
هيرشفيلد	hirschfeld
هيرشكو	hershko
هيرشكوفيتز	hershkovitz
هيرشل	herschel
هيرشي	hershey
هيرغيرت	herget
هيرفاس	hervas
هيرفيسآري	hirvisaari
هيرفيه	herve
هيركوليز	herculez
هيرلي	hurley
هيرمان	hermann
هيرمان‬‎	herrmann
هيرمت	hermite
هيرموغينيس	hermogenes
هيرنانديز	hernandez
هيرو	hiro
هيروأكي	hiroaki
هيروبومي	hirobumi
هيروتا	hirota
هيروس	hirose
هيروسويه	hirosue
هيروشي	hiroshi
هيروفمي	hirofumi
هيروكو	hiroko
هيرومي	hiromi
هيرون	herron
هيرونيموس	hieronymus
هيرويوكي	hiroyuki
هيريبيرتو	heriberto
هيريرا	herrera
هيريرو	herrero
هيريك	herrick
هيريمانز	heremans
هيزاكازو	hisakazu
هيساتو	hisato
هيساكاوا	hisakawa
هيسايشي	hisaishi
هيستون	heston
هيسجيدال	hesjedal
هيسر	hyser
هيسك	hasek
هيسل	hesl
هيسلر	hessler
هيسلوب	hislop
هيسلوف	heslov
هيسين	hysen
هيغاشينو	higashino
هيغز	higgs
هيغنر	heegner
هيغواين	higuain
هيغوتشي	higuchi
هيغوراس	higueras
هيغينبوثام	higginbotham
هيغينز	higgins
هيفتن	haeften
هيفنر	hefner
هيفيرن	heffern
هيكارو	hikaru
هيكتور	hector
هيل	hill
هيلاند	hiland
هيلبرت	hilbert
هيلتون	hilton
هيلجيمارك	hiljemark
هيلد	held
هيلدبراند	hildebrand
هيلدريث	hildreth
هيلدون	heldon
هيلديتش	hilditch
هيلر	heller
هيلرمان	hillerman
هيلفردنج	hilferding
هيلمرت	helmert
هيلمز	helms
هيلمس	helmes
هيلمنغر	helminger
هيلموت	helmut
هيلنجر	hellinger
هيلنس	heylens
هيليارد	hilliard
هيليبويك	hellebuyck
هيلير	hilaire
هيليغيرا	helguera
هيليمانس	hellemans
هيلين	helen
هيلينا	helena
هيلينيو	helenio
هيلينيوس	helenius
هيليو	helio
هيمبليمان	hempleman
هيمسورث	hemsworth
هيملر	himmler
هيمي	hemme
هيمينغز	hemmings
هينبارت	hengbart
هينترماير	hintermaier
هينتزه	heintze
هينتشوز	henchoz
هينتون	hinton
هينج	heng
هينجيز	hingis
هيندسن	hinson
هيندنبورغ	hindenburg
هينر	heiner
هينري	henri
هينريتش	hinrich
هينريكي	henrique
هينز	haynes
هينسون	henson
هينغ	henig
هينغي	hinge
هينمان	henman
هينو	hino
هينوود	henwood
هينيمان	heynemann
هينينغ	henning
هيهات	hihat
هيوارث	hayworth
هيوارد	hayward
هيوجونغ	hyojong
هيود	heude
هيوستن	houston
هيوليان	hjulian
هيون	hyun
هيونجونغ	hyeonjong
وائل	wael
واتابي	watabe
واتارو	wataru
واتانابي	watanabe
واتركيين	waterkeyn
واتس	watts
واتسون	watson
واتشالسكي	wachalski
واتلنغ	watling
واتو	watteau
واجوكا	wajoka
واحد	wahid
وادا	wada
وادلو	wadlow
واربورتون	warburton
وارتون	warton
وارثي	warsi
وارد	ward
وارمن	waterman
وارنر	warner
وارنوك	warnock
وارويك	warwick
وارين	warren
وارينر	wariner
واس	wass
واسيج	waseige
واسيكوسكا	wasikowska
واسيلويسكي	wasilewski
واصف	wassef
واط	watt
واكا	waqa
واكانا	wakana
واكد	waked
واكر	walker
واكن	walken
واكيم	wakim
والبول	walpole
والبيرغ	wahlberg
والت	walt
والتمان	waltman
والتون	walton
والد	wald
والدمان	waldmann
والدو	waldo
والر	waller
والش	walsh
والكوت	walcott
والكووياك	walkowiak
والي	wally
واليس	wallis
واليش	wallich
واليمبو	oualembo
والين	whalin
والينجفورد	wallingford
وان	wan
واناماكير	wanamaker
واندا	wanda
وانشوب	wanchope
وانغ	wang
وانغشاك	wangchuck
وانلي	wanly
وايت	white
وايترز	waiters
وايتس	waits
وايتسايد	whiteside
وايتكير	whittaker
وايتمور	whitmore
وايتهاوس	whitehouse
وايتهيد	whitehead
وايتوورث	whitworth
وايث	wyeth
وايس	weiss
وايسفلوغ	weißflog
وايسهاوبت	weishaupt
وايكلف	wyclef
وايلد	wilde
وايلدر	wilder
وايلدروتر	wilderotter
وايلر	wyler
وايلون	waylon
وايمان	wyman
واين	wayne
واينبرغر	weinberger
وبران	wabran
وجسيكي	wojcicki
وحشي	wahshi
وحيد	vahid
وحيدي	vahidi
ودبريدج	woodbridge
ودل	weddell
ودود	wadud
ودورد	woodward
وراق	warraq
ورث	wirth
وردة	wardeh
ورذينجتن	worthington
ورقة	waraka
ورمبراند	wurmbrand
وريد	wrede
وزنياك	wozniak
وزيري	vaziri
وسام	wissam
وستبروك	westbrook
وستكوت	westcott
وستون	weston
وسكس	wessex
وسوف	wassouf
وصفي	wasfi
وضاحي	ouadahi
وطار	ouettar
وطبان	watban
وعزيز	ouaziz
وفاء	wafa
ولادة	wallada
ولاستون	wollaston
ولد	ould
ولدريزتش	włodarczyk
ولز	wells
ولستد	wellsted
ولش	welch
ولف	wolf
ولفويتس	wolfowitz
ولنبرغ	wallenberg
وليامسون	williamson
ون	wenjin
وندلاند	wendland
وندلين	wendelin
ونوس	wannous
وهبة	wahba
وهبي	wahbi
وهيب	wuhayb
وو	wu
ووترز	waters
ووترس	wouters
ووترهاوس	waterhouse
وود	wood
وودرو	woodrow
وودروف	woodruff
وودز	woods
وودغيت	woodgate
وودفيل	woodville
وودكوك	woodcock
وودمان	woodman
وودي	woody
ووردزوورث	wordsworth
وورز	wurz
وورغو	worgu
وورف	whorf
ووشر	washer
ووك	wook
وولستونكرافت	wollstonecraft
وولسي	wolsey
وولـف	woolf
وولفسن	woolfson
وولفشول	wolfshohl
وولفلي	wolfli
وولكوويسكي	wolkowyski
وومي	wome
وونغ	wong
وويس	woese
ويا	weah
ويان	weian
ويانز	wayans
ويب	webb
ويبر	webber
ويبو	webo
ويت	witte
ويتا	waita
ويتزر	wetzer
ويتشجه	witschge
ويتشرلي	wycherley
ويتفيلد	whitfield
ويتل	whittle
ويتلي	wheatley
ويتمان	whitman
ويتن	witten
ويتنبرغ	wittenberg
ويتني	whitney
ويتير	wheater
ويثرلي	weatherly
ويجينز	wiggins
ويد	wade
ويديربورن	wedderburn
ويديمان	wedeman
ويدينوس	widenius
ويذاي	withey
ويذرسبون	witherspoon
ويرايودا	wirajuda
ويرتا	huerta
ويرتز	wiertz
ويرستراس	weierstrass
ويرينغ	waring
ويز	wiz
ويزدوم	wisdom
ويس	wes
ويستار	wistar
ويستهيد	westhead
ويستينغهاوس	westinghouse
ويسلي	wesley
ويغان	weygand
ويفر	weaver
ويفينغ	weifeng
ويك	wake
ويكراماسينغ	wickramasinghe
ويكس	weeks
ويكلوند	wiklund
ويكند	weeknd
ويكينهايزر	wickenheiser
ويل	will
ويلارد	willard
ويلان	whelan
ويلاند	wiland
ويلبيك	welbeck
ويلت	wilt
ويلتورد	wiltord
ويلدنو	willdenow
ويلدينج	wilding
ويلر	wheeler
ويلزدورف	wilsdorf
ويلسن	wilson
ويلشير	wilshere
ويلكزك	wilczek
ويلكس	wilkes
ويلكشير	wilkshire
ويلكنز	wilkins
ويلكوكس	willcocks
ويلكي	wilkie
ويلكينسون	wilkinson
ويلنس	wellens
ويلهلمسون	wilhelmsson
ويلو	willow
ويلي	willy
ويليام	william
ويليامز	williams
ويليس	willis
ويليغتون	weligton
ويليم	willem
ويلينغ	welling
ويلينغهام	willingham
ويلينمان	weilenmann
ويم	wim
ويمبي	wimbee
ويمر	wimmer
وينالدا	wynalda
وينترز	winters
وينتورث	wentworth
وينتون	winton
وينجر	weinger
ويندسور	windsor
ويندلينغ	wendling
ويندهام	wyndham
ويندي	wendy
وينر	weiner
وينستد	winstead
وينستيكيرز	wijnstekers
وينسلو	winslow
وينشل	winchell
وينغارد	wijngaarde
وينغر	wenger
وينغيرت	wingert
وينفيلد	winfield
وينكسيا	wenxia
وينكلر	winkler
وينكيلهوك	winkelhock
وينيون	wenyuan
ويهورست	wieghorst
ويوي	weiwei
وييرجونس	weyergans
يائير	yair
يابينغ	yaping
ياتاباري	yatabare
ياتارا	yattara
ياتايني	battaini
ياجيما	yajima
ياداف	yadav
يارتسيف	yartsev
يارد	yared
يارني	jarni
يارنيفلت	jarnefelt
ياروشيك	jarosik
ياروليم	jarolim
ياري	yari
يازالدي	yazalde
ياسبرس	jaspers
ياسر	yasser
ياسف	yacef
ياسموتو	yasumoto
ياسمين	yasmine
ياسنوري	yasunori
ياسوأكي	yasuaki
ياسوشي	yasushi
ياشين	yashin
ياغر	jager
ياغو	iago
يافاناينن	javanainen
ياكش	yakıs
ياكوب	jakob
ياكوبسون	jakobson
ياكوبكو	jakubko
ياكوينتا	iaquinta
ياكين	yakin
ياما	higashiyama
يامادرا	yamadera
يامازاكي	yamazaki
ياماساكي	yamasaki
ياماغوتشي	yamaguchi
ياماغيشي	yamagishi
ياماموتو	yamamoto
ياماناكا	yamanaka
ياماوكا	yamaoka
ياموتشي	yamauchi
يامين	yamin
يان	jan
يانا	yana
يانار	yanar
ياناييف	yanayev
ياندا	janda
ياندل	jandl
يانسن	jansen
يانسون	jansson
يانسي	yancey
يانش	jaenisch
يانغ	yang
يانكر	janker
يانكو	janko
يانكوفسكي	jankowski
يانكولوفسكي	jankulovski
يانوزاي	januzaj
يانوش	janos
يانوكوفيتش	yanukovych
يانيراس	llaneras
يانيز	yanez
يانيس	giannis
يانيك	yannick
يايا	yaya
يايسله	jaissle
يبدة	yebda
يبواه	yeboah
يبيس	yepes
يتسحاق	yitzhak
يحيى	yahya
يدان	yedan
يدلين	yadlin
يركسا	yerxa
يزدجرد	yazdegerd
يسبر	jesper
يشار	yasar
يشوعيهب	ishoyahb
يصهار	izhar
يعاري	yaari
يعته	yata
يعفر	ya'fur
يعلون	ya'alon
يعيش	yaish
يغوروفا	yegorova
يفريوزهيكين	yevryuzhikhin
يفيس	yves
يفيموفيتش	yefimovich
يكرشام	wickersham
يكن	yakan
يلتسن	yeltsin
يلشين	yelchin
يلند	yelland
يليديل	yelldell
يلين	yellen
يلينا	yelena
يماني	yamani
يمن	yumn
يميتس	yemets
يميليانوف	yemelyanov
يمينة	benyamina
ينجباروف	yengibarov
يندريشيك	jendrisek
ينسين	jensen
يهودا	yehuda
يهيل	yahel
يو	yu
يواخيم	joachim
يواسيم	joacim
يوان	yuan
يوانكينج	yuanqing
يوبو	yobo
يوتاكا	yutaka
يوتنيك	putnik
يوتوني	jotuni
يوثام	jotham
يوجني	youzhny
يوجي	yuji
يوحنس	yohannes
يوخن	jochen
يودس	eudes
يودنيتش	yudenich
يورام	yoram
يورتشيخين	yurchikhin
يورغن	jurgen
يورغنسن	jørgensen
يورك	york
يوركميك	jurkemik
يوروفسكي	yourofsky
يورياكو	yuryaku
يوريتومو	yoritomo
يوريديكا	eurydice
يوريس	joris
يوريكو	yuriko
يوساكو	yusaku
يوستي	yuste
يوسي	yossi
يوش	oesch
يوشتشينكو	yushchenko
يوشكا	joschka
يوشيتاكا	yoshitaka
يوشيتسغو	yoshitsugu
يوشيدا	yoshida
يوشيزاوا	yoshizawa
يوشيفومي	yoshifumi
يوشيكاوا	yoshikawa
يوشيموري	yoshimori
يوشيمونه	yoshimune
يوشيميتسو	yoshimitsu
يوشيناكا	yoshinaka
يوشينو	yoshino
يوشينوبو	yoshinobu
يوشينوري	yoshinori
يوشيهيسا	yoshihisa
يوغا	youga
يوغوسلافيا	yugoslavia
يوفارا	juvarra
يوفان	iofan
يوكا	yuka
يوكاري	yukari
يوكاوا	yukawa
يوكوز	yoccoz
يوكوزاوا	yokozawa
يوكون	yaokun
يوكيا	yukiya
يوكيتوشي	yukitoshi
يوكيكو	yukiko
يوكيهيرو	yukihiro
يوكيو	yukio
يولاند	yolande
يوليا	yulia
يوليان	julian
يوليوس	julius
يومانز	yeomans
يومي	yumi
يوميكو	yumiko
يومينس	eumenes
يونا	yoona
يوناسون	jonasson
يونتشا	yontcha
يونج	young
يونسان	yeonsangun
يونسي	younesi
يونغسما	jongsma
يونغلي	yongle
يونغهازبند	younghusband
يونغهانز	junghans
يونيك	junek
يوه	yeoh
يوهاس	juhasz
يوهان	johann
يوهانس	johannes
يوهانسن	johansen
يوهانسون	johansson
يوهي	yohei
يوي	yui
يويا	yuya
يوينغ	ewing
يياغر	yeager
ييب	yip
ييجونغ	yejong
ييرا	llera
ييستي	yeste
ييمو	yimou
ييه	yeh
کاظم	kadhim
کیتینغر	kittinger
